RECORD_ID,LOAN_ID,PERIOD,PAYMENT_DATE,BEGINING_BALANCE,PAYMENT_AMOUNT,PAYMENT_PRINCIPLE,PAYMENT_INTEREST,ENDING_BALANCE,PAID,DATE,CREATED_BY,CREATED_DT,TRANS_REF
238263,165444,1,1/11/2020,108343990,2545675,1208095,1337580,105798315,Y,1/11/2020,9,1/10/2020,274071
238264,165444,2,1/12/2020,107120794,2545675,1223196,1322479,104575119,Y,1/12/2020,9,1/10/2020,275450
238265,165444,3,1/1/2021,105882308,2545675,1238486,1307189,103336633,N,NULL,9,1/10/2020,NULL
238266,165444,4,1/2/2021,104628341,2545675,1253967,1291708,102082666,N,NULL,9,1/10/2020,NULL
238267,165444,5,1/3/2021,103358699,2545675,1269642,1276033,100813024,N,NULL,9,1/10/2020,NULL
238268,165444,6,1/4/2021,102073187,2545675,1285512,1260163,99527512,N,NULL,9,1/10/2020,NULL
238269,165444,7,1/5/2021,100771606,2545675,1301581,1244094,98225931,N,NULL,9,1/10/2020,NULL
238270,165444,8,1/6/2021,99453755,2545675,1317851,1227824,96908080,N,NULL,9,1/10/2020,NULL
238271,165444,9,1/7/2021,98119431,2545675,1334324,1211351,95573756,N,NULL,9,1/10/2020,NULL
238272,165444,10,1/8/2021,96768428,2545675,1351003,1194672,94222753,N,NULL,9,1/10/2020,NULL
238273,165444,11,1/9/2021,95400537,2545675,1367891,1177784,92854862,N,NULL,9,1/10/2020,NULL
238274,165444,12,1/10/2021,94015548,2545675,1384989,1160686,91469873,N,NULL,9,1/10/2020,NULL
238275,165444,13,1/11/2021,92613246,2545675,1402302,1143373,90067571,N,NULL,9,1/10/2020,NULL
238276,165444,14,1/12/2021,91193416,2545675,1419830,1125845,88647741,N,NULL,9,1/10/2020,NULL
238277,165444,15,1/1/2022,89755838,2545675,1437578,1108097,87210163,N,NULL,9,1/10/2020,NULL
238278,165444,16,1/2/2022,88300290,2545675,1455548,1090127,85754615,N,NULL,9,1/10/2020,NULL
238279,165444,17,1/3/2022,86826548,2545675,1473742,1071933,84280873,N,NULL,9,1/10/2020,NULL
238280,165444,18,1/4/2022,85334384,2545675,1492164,1053511,82788709,N,NULL,9,1/10/2020,NULL
238281,165444,19,1/5/2022,83823568,2545675,1510816,1034859,81277893,N,NULL,9,1/10/2020,NULL
238282,165444,20,1/6/2022,82293867,2545675,1529701,1015974,79748192,N,NULL,9,1/10/2020,NULL
238283,165444,21,1/7/2022,80745044,2545675,1548823,996852,78199369,N,NULL,9,1/10/2020,NULL
238284,165444,22,1/8/2022,79176861,2545675,1568183,977492,76631186,N,NULL,9,1/10/2020,NULL
238285,165444,23,1/9/2022,77589076,2545675,1587785,957890,75043401,N,NULL,9,1/10/2020,NULL
238286,165444,24,1/10/2022,75981443,2545675,1607633,938043,73435768,N,NULL,9,1/10/2020,NULL
238287,165444,25,1/11/2022,74353715,2545675,1627728,917947,71808040,N,NULL,9,1/10/2020,NULL
238288,165444,26,1/12/2022,72705640,2545675,1648075,897600,70159965,N,NULL,9,1/10/2020,NULL
238289,165444,27,1/1/2023,71036965,2545675,1668675,877000,68491290,N,NULL,9,1/10/2020,NULL
238290,165444,28,1/2/2023,69347431,2545675,1689534,856141,66801756,N,NULL,9,1/10/2020,NULL
238291,165444,29,1/3/2023,67636778,2545675,1710653,835022,65091103,N,NULL,9,1/10/2020,NULL
238292,165444,30,1/4/2023,65904742,2545675,1732036,813639,63359067,N,NULL,9,1/10/2020,NULL
238293,165444,31,1/5/2023,64151055,2545675,1753687,791988,61605380,N,NULL,9,1/10/2020,NULL
238294,165444,32,1/6/2023,62375447,2545675,1775608,770067,59829772,N,NULL,9,1/10/2020,NULL
238295,165444,33,1/7/2023,60577644,2545675,1797803,747872,58031969,N,NULL,9,1/10/2020,NULL
238296,165444,34,1/8/2023,58757369,2545675,1820275,725400,56211694,N,NULL,9,1/10/2020,NULL
238297,165444,35,1/9/2023,56914340,2545675,1843029,702646,54368665,N,NULL,9,1/10/2020,NULL
238298,165444,36,1/10/2023,55048273,2545675,1866067,679608,52502598,N,NULL,9,1/10/2020,NULL
238299,165444,37,1/11/2023,53158880,2545675,1889393,656282,50613205,N,NULL,9,1/10/2020,NULL
238300,165444,38,1/12/2023,51245870,2545675,1913010,632665,48700195,N,NULL,9,1/10/2020,NULL
238301,165444,39,1/1/2024,49308947,2545675,1936923,608752,46763272,N,NULL,9,1/10/2020,NULL
238302,165444,40,1/2/2024,47347813,2545675,1961134,584541,44802138,N,NULL,9,1/10/2020,NULL
238303,165444,41,1/3/2024,45362165,2545675,1985648,560027,42816490,N,NULL,9,1/10/2020,NULL
238304,165444,42,1/4/2024,43351696,2545675,2010469,535206,40806021,N,NULL,9,1/10/2020,NULL
238305,165444,43,1/5/2024,41316096,2545675,2035600,510075,38770421,N,NULL,9,1/10/2020,NULL
238306,165444,44,1/6/2024,39255051,2545675,2061045,484630,36709376,N,NULL,9,1/10/2020,NULL
238307,165444,45,1/7/2024,37168243,2545675,2086808,458867,34622568,N,NULL,9,1/10/2020,NULL
238308,165444,46,1/8/2024,35055350,2545675,2112893,432782,32509675,N,NULL,9,1/10/2020,NULL
238309,165444,47,1/9/2024,32916046,2545675,2139304,406371,30370371,N,NULL,9,1/10/2020,NULL
238310,165444,48,1/10/2024,30750001,2545675,2166045,379630,28204326,N,NULL,9,1/10/2020,NULL
238311,165444,49,1/11/2024,28556880,2545675,2193121,352554,26011205,N,NULL,9,1/10/2020,NULL
238312,165444,50,1/12/2024,26336345,2545675,2220535,325140,23790670,N,NULL,9,1/10/2020,NULL
238313,165444,51,1/1/2025,24088053,2545675,2248292,297383,21542378,N,NULL,9,1/10/2020,NULL
238314,165444,52,1/2/2025,21811658,2545675,2276395,269280,19265983,N,NULL,9,1/10/2020,NULL
238315,165444,53,1/3/2025,19506808,2545675,2304850,240825,16961133,N,NULL,9,1/10/2020,NULL
238316,165444,54,1/4/2025,17173147,2545675,2333661,212014,14627472,N,NULL,9,1/10/2020,NULL
238317,165444,55,1/5/2025,14810315,2545675,2362832,182843,12264640,N,NULL,9,1/10/2020,NULL
238318,165444,56,1/6/2025,12417948,2545675,2392367,153308,9872273,N,NULL,9,1/10/2020,NULL
238319,165444,57,1/7/2025,9995676,2545675,2422272,123403,7450001,N,NULL,9,1/10/2020,NULL
238320,165444,58,1/8/2025,7543126,2545675,2452550,93125,4997451,N,NULL,9,1/10/2020,NULL
238321,165444,59,1/9/2025,5059919,2545675,2483207,62468,2514244,N,NULL,9,1/10/2020,NULL
238322,165444,60,1/10/2025,2545672,2545675,2514244,31428,0,N,NULL,9,1/10/2020,NULL
238323,165445,1,1/11/2020,13162500,361800,199300,162500,12800700,Y,1/11/2020,9,1/10/2020,274070
238324,165445,2,1/12/2020,12960709,361800,201791,160009,12598909,Y,1/12/2020,9,1/10/2020,275449
238325,165445,3,1/1/2021,12756396,361800,204313,157486,12394596,N,NULL,9,1/10/2020,NULL
238326,165445,4,1/2/2021,12549529,361800,206867,154932,12187729,N,NULL,9,1/10/2020,NULL
238327,165445,5,1/3/2021,12340076,361800,209453,152347,11978276,N,NULL,9,1/10/2020,NULL
238328,165445,6,1/4/2021,12128005,361800,212071,149728,11766205,N,NULL,9,1/10/2020,NULL
238329,165445,7,1/5/2021,11913283,361800,214722,147078,11551483,N,NULL,9,1/10/2020,NULL
238330,165445,8,1/6/2021,11695877,361800,217406,144394,11334077,N,NULL,9,1/10/2020,NULL
238331,165445,9,1/7/2021,11475753,361800,220124,141676,11113953,N,NULL,9,1/10/2020,NULL
238332,165445,10,1/8/2021,11252878,361800,222875,138924,10891078,N,NULL,9,1/10/2020,NULL
238333,165445,11,1/9/2021,11027217,361800,225661,136138,10665417,N,NULL,9,1/10/2020,NULL
238334,165445,12,1/10/2021,10798735,361800,228482,133318,10436935,N,NULL,9,1/10/2020,NULL
238335,165445,13,1/11/2021,10567397,361800,231338,130462,10205597,N,NULL,9,1/10/2020,NULL
238336,165445,14,1/12/2021,10333167,361800,234230,127570,9971367,N,NULL,9,1/10/2020,NULL
238337,165445,15,1/1/2022,10096009,361800,237158,124642,9734209,N,NULL,9,1/10/2020,NULL
238338,165445,16,1/2/2022,9855887,361800,240122,121678,9494087,N,NULL,9,1/10/2020,NULL
238339,165445,17,1/3/2022,9612763,361800,243124,118676,9250963,N,NULL,9,1/10/2020,NULL
238340,165445,18,1/4/2022,9366600,361800,246163,115637,9004800,N,NULL,9,1/10/2020,NULL
238341,165445,19,1/5/2022,9117360,361800,249240,112560,8755560,N,NULL,9,1/10/2020,NULL
238342,165445,20,1/6/2022,8865005,361800,252355,109444,8503205,N,NULL,9,1/10/2020,NULL
238343,165445,21,1/7/2022,8609495,361800,255510,106290,8247695,N,NULL,9,1/10/2020,NULL
238344,165445,22,1/8/2022,8350791,361800,258704,103096,7988991,N,NULL,9,1/10/2020,NULL
238345,165445,23,1/9/2022,8088854,361800,261937,99862,7727054,N,NULL,9,1/10/2020,NULL
238346,165445,24,1/10/2022,7823642,361800,265212,96588,7461842,N,NULL,9,1/10/2020,NULL
238347,165445,25,1/11/2022,7555115,361800,268527,93273,7193315,N,NULL,9,1/10/2020,NULL
238348,165445,26,1/12/2022,7283232,361800,271883,89916,6921432,N,NULL,9,1/10/2020,NULL
238349,165445,27,1/1/2023,7007950,361800,275282,86518,6646150,N,NULL,9,1/10/2020,NULL
238350,165445,28,1/2/2023,6729227,361800,278723,83077,6367427,N,NULL,9,1/10/2020,NULL
238351,165445,29,1/3/2023,6447020,361800,282207,79593,6085220,N,NULL,9,1/10/2020,NULL
238352,165445,30,1/4/2023,6161286,361800,285734,76065,5799486,N,NULL,9,1/10/2020,NULL
238353,165445,31,1/5/2023,5871980,361800,289306,72494,5510180,N,NULL,9,1/10/2020,NULL
238354,165445,32,1/6/2023,5579058,361800,292922,68877,5217258,N,NULL,9,1/10/2020,NULL
238355,165445,33,1/7/2023,5282474,361800,296584,65216,4920674,N,NULL,9,1/10/2020,NULL
238356,165445,34,1/8/2023,4982183,361800,300291,61508,4620383,N,NULL,9,1/10/2020,NULL
238357,165445,35,1/9/2023,4678138,361800,304045,57755,4316338,N,NULL,9,1/10/2020,NULL
238358,165445,36,1/10/2023,4370292,361800,307846,53954,4008492,N,NULL,9,1/10/2020,NULL
238359,165445,37,1/11/2023,4058598,361800,311694,50106,3696798,N,NULL,9,1/10/2020,NULL
238360,165445,38,1/12/2023,3743008,361800,315590,46210,3381208,N,NULL,9,1/10/2020,NULL
238361,165445,39,1/1/2024,3423473,361800,319535,42265,3061673,N,NULL,9,1/10/2020,NULL
238362,165445,40,1/2/2024,3099944,361800,323529,38271,2738144,N,NULL,9,1/10/2020,NULL
238363,165445,41,1/3/2024,2772371,361800,327573,34227,2410571,N,NULL,9,1/10/2020,NULL
238364,165445,42,1/4/2024,2440703,361800,331668,30132,2078903,N,NULL,9,1/10/2020,NULL
238365,165445,43,1/5/2024,2104890,361800,335813,25986,1743090,N,NULL,9,1/10/2020,NULL
238366,165445,44,1/6/2024,1764879,361800,340011,21789,1403079,N,NULL,9,1/10/2020,NULL
238367,165445,45,1/7/2024,1420618,361800,344261,17539,1058818,N,NULL,9,1/10/2020,NULL
238368,165445,46,1/8/2024,1072054,361800,348564,13235,710254,N,NULL,9,1/10/2020,NULL
238369,165445,47,1/9/2024,719132,361800,352922,8878,357332,N,NULL,9,1/10/2020,NULL
238370,165445,48,1/10/2024,361799,361800,357332,4467,0,N,NULL,9,1/10/2020,NULL
238371,135004,1,3/10/2020,11913282,734032,586955,147078,11179250,Y,3/10/2020,9,1/10/2020,272831
238372,135004,2,3/11/2020,11318990,734032,594292,139741,10584958,Y,3/11/2020,9,1/10/2020,274139
238373,135004,3,3/12/2020,10717270,734032,601720,132312,9983238,Y,3/12/2020,9,1/10/2020,275639
238374,135004,4,3/1/2021,10108028,734032,609242,124790,9373996,N,NULL,9,1/10/2020,NULL
238375,135004,5,3/2/2021,9491171,734032,616857,117175,8757139,N,NULL,9,1/10/2020,NULL
238376,135004,6,3/3/2021,8866603,734032,624568,109464,8132571,N,NULL,9,1/10/2020,NULL
238377,135004,7,3/4/2021,8234228,734032,632375,101657,7500196,N,NULL,9,1/10/2020,NULL
238378,135004,8,3/5/2021,7593948,734032,640280,93752,6859916,N,NULL,9,1/10/2020,NULL
238379,135004,9,3/6/2021,6945665,734032,648283,85749,6211633,N,NULL,9,1/10/2020,NULL
238380,135004,10,3/7/2021,6289278,734032,656387,77645,5555246,N,NULL,9,1/10/2020,NULL
238381,135004,11,3/8/2021,5624686,734032,664592,69441,4890654,N,NULL,9,1/10/2020,NULL
238382,135004,12,3/9/2021,4951787,734032,672899,61133,4217755,N,NULL,9,1/10/2020,NULL
238383,135004,13,3/10/2021,4270477,734032,681310,52722,3536445,N,NULL,9,1/10/2020,NULL
238384,135004,14,3/11/2021,3580650,734032,689827,44206,2846618,N,NULL,9,1/10/2020,NULL
238385,135004,15,3/12/2021,2882201,734032,698449,35583,2148169,N,NULL,9,1/10/2020,NULL
238386,135004,16,3/1/2022,2175021,734032,707180,26852,1440989,N,NULL,9,1/10/2020,NULL
238387,135004,17,3/2/2022,1459001,734032,716020,18012,724969,N,NULL,9,1/10/2020,NULL
238388,135004,18,3/3/2022,734031,734032,724969,9062,0,N,NULL,9,1/10/2020,NULL
238389,165446,1,29/10/2020,810000,166050,156050,10000,643950,Y,29/10/2020,9,1/10/2020,273986
238390,165446,2,30/10/2020,652000,166050,158000,8049,485950,C,30/10/2020,9,1/10/2020,NULL
238391,165446,3,30/10/2020,492025,166050,159975,0,325975,C,30/10/2020,9,1/10/2020,NULL
238392,165446,4,30/10/2020,330050,166050,161975,0,164000,C,30/10/2020,9,1/10/2020,NULL
238393,165446,5,30/10/2020,166050,166050,164000,0,0,C,30/10/2020,9,1/10/2020,NULL
238394,165447,1,29/10/2020,10082189,345188,220716,124471,9737001,Y,29/10/2020,9,1/10/2020,273985
238395,165447,2,29/11/2020,9858714,345188,223475,121713,9513526,Y,29/11/2020,9,1/10/2020,275354
238396,165447,3,29/12/2020,9632446,345188,226268,118919,9287258,N,NULL,9,1/10/2020,NULL
238397,165447,4,29/01/2021,9403349,345188,229097,116091,9058161,N,NULL,9,1/10/2020,NULL
238398,165447,5,28/02/2021,9171388,345188,231961,113227,8826200,N,NULL,9,1/10/2020,NULL
238399,165447,6,28/03/2021,8936528,345188,234860,110328,8591340,N,NULL,9,1/10/2020,NULL
238400,165447,7,28/04/2021,8698732,345188,237796,107392,8353544,N,NULL,9,1/10/2020,NULL
238401,165447,8,28/05/2021,8457964,345188,240768,104419,8112776,N,NULL,9,1/10/2020,NULL
238402,165447,9,28/06/2021,8214186,345188,243778,101410,7868998,N,NULL,9,1/10/2020,NULL
238403,165447,10,28/07/2021,7967361,345188,246825,98362,7622173,N,NULL,9,1/10/2020,NULL
238404,165447,11,28/08/2021,7717451,345188,249910,95277,7372263,N,NULL,9,1/10/2020,NULL
238405,165447,12,28/09/2021,7464417,345188,253034,92153,7119229,N,NULL,9,1/10/2020,NULL
238406,165447,13,28/10/2021,7208220,345188,256197,88990,6863032,N,NULL,9,1/10/2020,NULL
238407,165447,14,28/11/2021,6948820,345188,259400,85788,6603632,N,NULL,9,1/10/2020,NULL
238408,165447,15,28/12/2021,6686178,345188,262642,82545,6340990,N,NULL,9,1/10/2020,NULL
238409,165447,16,28/01/2022,6420253,345188,265925,79262,6075065,N,NULL,9,1/10/2020,NULL
238410,165447,17,28/02/2022,6151004,345188,269249,75938,5805816,N,NULL,9,1/10/2020,NULL
238411,165447,18,28/03/2022,5878389,345188,272615,72573,5533201,N,NULL,9,1/10/2020,NULL
238412,165447,19,28/04/2022,5602366,345188,276023,69165,5257178,N,NULL,9,1/10/2020,NULL
238413,165447,20,28/05/2022,5322893,345188,279473,65715,4977705,N,NULL,9,1/10/2020,NULL
238414,165447,21,28/06/2022,5039927,345188,282966,62221,4694739,N,NULL,9,1/10/2020,NULL
238415,165447,22,28/07/2022,4753424,345188,286503,58684,4408236,N,NULL,9,1/10/2020,NULL
238416,165447,23,28/08/2022,4463339,345188,290085,55103,4118151,N,NULL,9,1/10/2020,NULL
238417,165447,24,28/09/2022,4169628,345188,293711,51477,3824440,N,NULL,9,1/10/2020,NULL
238418,165447,25,28/10/2022,3872246,345188,297382,47806,3527058,N,NULL,9,1/10/2020,NULL
238419,165447,26,28/11/2022,3571147,345188,301099,44088,3225959,N,NULL,9,1/10/2020,NULL
238420,165447,27,28/12/2022,3266284,345188,304863,40324,2921096,N,NULL,9,1/10/2020,NULL
238421,165447,28,28/01/2023,2957610,345188,308674,36514,2612422,N,NULL,9,1/10/2020,NULL
238422,165447,29,28/02/2023,2645078,345188,312532,32655,2299890,N,NULL,9,1/10/2020,NULL
238423,165447,30,28/03/2023,2328639,345188,316439,28749,1983451,N,NULL,9,1/10/2020,NULL
238424,165447,31,28/04/2023,2008245,345188,320394,24793,1663057,N,NULL,9,1/10/2020,NULL
238425,165447,32,28/05/2023,1683846,345188,324399,20788,1338658,N,NULL,9,1/10/2020,NULL
238426,165447,33,28/06/2023,1355392,345188,328454,16733,1010204,N,NULL,9,1/10/2020,NULL
238427,165447,34,28/07/2023,1022832,345188,332560,12628,677644,N,NULL,9,1/10/2020,NULL
238428,165447,35,28/08/2023,686115,345188,336717,8471,340927,N,NULL,9,1/10/2020,NULL
238429,165447,36,28/09/2023,345189,345188,340927,4262,0,N,NULL,9,1/10/2020,NULL
238430,165448,1,29/10/2020,6581250,339770,258520,81250,6241480,Y,29/10/2020,9,5/10/2020,273984
238431,165448,2,29/11/2020,6319498,339770,261752,78018,5979728,Y,29/11/2020,9,5/10/2020,275353
238432,165448,3,29/12/2020,6054474,339770,265024,74747,5714704,N,NULL,9,5/10/2020,NULL
238433,165448,4,29/01/2021,5786137,339770,268337,71434,5446367,N,NULL,9,5/10/2020,NULL
238434,165448,5,28/02/2021,5514446,339770,271691,68080,5174676,N,NULL,9,5/10/2020,NULL
238435,165448,6,28/03/2021,5239359,339770,275087,64683,4899589,N,NULL,9,5/10/2020,NULL
238436,165448,7,28/04/2021,4960833,339770,278526,61245,4621063,N,NULL,9,5/10/2020,NULL
238437,165448,8,28/05/2021,4678826,339770,282007,57763,4339056,N,NULL,9,5/10/2020,NULL
238438,165448,9,28/06/2021,4393294,339770,285532,54238,4053524,N,NULL,9,5/10/2020,NULL
238439,165448,10,28/07/2021,4104193,339770,289101,50669,3764423,N,NULL,9,5/10/2020,NULL
238440,165448,11,28/08/2021,3811478,339770,292715,47055,3471708,N,NULL,9,5/10/2020,NULL
238441,165448,12,28/09/2021,3515104,339770,296374,43396,3175334,N,NULL,9,5/10/2020,NULL
238442,165448,13,28/10/2021,3215025,339770,300079,39692,2875255,N,NULL,9,5/10/2020,NULL
238443,165448,14,28/11/2021,2911195,339770,303830,35941,2571425,N,NULL,9,5/10/2020,NULL
238444,165448,15,28/12/2021,2603567,339770,307628,32143,2263797,N,NULL,9,5/10/2020,NULL
238445,165448,16,28/01/2022,2292094,339770,311473,28297,1952324,N,NULL,9,5/10/2020,NULL
238446,165448,17,28/02/2022,1976728,339770,315366,24404,1636958,N,NULL,9,5/10/2020,NULL
238447,165448,18,28/03/2022,1657420,339770,319308,20462,1317650,N,NULL,9,5/10/2020,NULL
238448,165448,19,28/04/2022,1334120,339770,323300,16471,994350,N,NULL,9,5/10/2020,NULL
238449,165448,20,28/05/2022,1006779,339770,327341,12429,667009,N,NULL,9,5/10/2020,NULL
238450,165448,21,28/06/2022,675346,339770,331433,8338,335576,N,NULL,9,5/10/2020,NULL
238451,165448,22,28/07/2022,339770,339770,335576,4195,0,N,NULL,9,5/10/2020,NULL
238452,165449,1,30/10/2020,5568750,361131,292381,68750,5207619,Y,30/10/2020,9,5/10/2020,274040
238453,165449,2,30/11/2020,5272714,361131,296036,65095,4911583,Y,30/11/2020,9,5/10/2020,275387
238454,165449,3,30/12/2020,4972977,361131,299737,61395,4611846,N,NULL,9,5/10/2020,NULL
238455,165449,4,30/01/2021,4669494,361131,303483,57648,4308363,N,NULL,9,5/10/2020,NULL
238456,165449,5,28/02/2021,4362217,361131,307277,53855,4001086,N,NULL,9,5/10/2020,NULL
238457,165449,6,28/03/2021,4051099,361131,311118,50014,3689968,N,NULL,9,5/10/2020,NULL
238458,165449,7,28/04/2021,3736092,361131,315007,46125,3374961,N,NULL,9,5/10/2020,NULL
238459,165449,8,28/05/2021,3417148,361131,318944,42187,3056017,N,NULL,9,5/10/2020,NULL
238460,165449,9,28/06/2021,3094217,361131,322931,38200,2733086,N,NULL,9,5/10/2020,NULL
238461,165449,10,28/07/2021,2767249,361131,326968,34164,2406118,N,NULL,9,5/10/2020,NULL
238462,165449,11,28/08/2021,2436194,361131,331055,30076,2075063,N,NULL,9,5/10/2020,NULL
238463,165449,12,28/09/2021,2101001,361131,335193,25938,1739870,N,NULL,9,5/10/2020,NULL
238464,165449,13,28/10/2021,1761618,361131,339383,21748,1400487,N,NULL,9,5/10/2020,NULL
238465,165449,14,28/11/2021,1417993,361131,343625,17506,1056862,N,NULL,9,5/10/2020,NULL
238466,165449,15,28/12/2021,1070072,361131,347921,13211,708941,N,NULL,9,5/10/2020,NULL
238467,165449,16,28/01/2022,717802,361131,352270,8862,356671,N,NULL,9,5/10/2020,NULL
238468,165449,17,28/02/2022,361129,361131,356671,4458,0,N,NULL,9,5/10/2020,NULL
238469,165450,1,30/10/2020,10024178,480038,356283,123755,9544140,Y,30/10/2020,9,5/10/2020,274039
238470,165450,2,30/11/2020,9663441,480038,360737,119302,9183403,Y,30/11/2020,9,5/10/2020,275386
238471,165450,3,30/12/2020,9298195,480038,365246,114793,8818157,N,NULL,9,5/10/2020,NULL
238472,165450,4,30/01/2021,8928384,480038,369811,110227,8448346,N,NULL,9,5/10/2020,NULL
238473,165450,5,28/02/2021,8553950,480038,374434,105604,8073912,N,NULL,9,5/10/2020,NULL
238474,165450,6,28/03/2021,8174836,480038,379114,100924,7694798,N,NULL,9,5/10/2020,NULL
238475,165450,7,28/04/2021,7790983,480038,383853,96185,7310945,N,NULL,9,5/10/2020,NULL
238476,165450,8,28/05/2021,7402331,480038,388652,91387,6922293,N,NULL,9,5/10/2020,NULL
238477,165450,9,28/06/2021,7008821,480038,393510,86529,6528783,N,NULL,9,5/10/2020,NULL
238478,165450,10,28/07/2021,6610392,480038,398429,81610,6130354,N,NULL,9,5/10/2020,NULL
238479,165450,11,28/08/2021,6206983,480038,403409,76629,5726945,N,NULL,9,5/10/2020,NULL
238480,165450,12,28/09/2021,5798531,480038,408452,71587,5318493,N,NULL,9,5/10/2020,NULL
238481,165450,13,28/10/2021,5384974,480038,413557,66481,4904936,N,NULL,9,5/10/2020,NULL
238482,165450,14,28/11/2021,4966247,480038,418727,61312,4486209,N,NULL,9,5/10/2020,NULL
238483,165450,15,28/12/2021,4542286,480038,423961,56078,4062248,N,NULL,9,5/10/2020,NULL
238484,165450,16,28/01/2022,4113026,480038,429260,50778,3632988,N,NULL,9,5/10/2020,NULL
238485,165450,17,28/02/2022,3678400,480038,434626,45412,3198362,N,NULL,9,5/10/2020,NULL
238486,165450,18,28/03/2022,3238341,480038,440059,39980,2758303,N,NULL,9,5/10/2020,NULL
238487,165450,19,28/04/2022,2792781,480038,445560,34479,2312743,N,NULL,9,5/10/2020,NULL
238488,165450,20,28/05/2022,2341652,480038,451129,28909,1861614,N,NULL,9,5/10/2020,NULL
238489,165450,21,28/06/2022,1884884,480038,456768,23270,1404846,N,NULL,9,5/10/2020,NULL
238490,165450,22,28/07/2022,1422406,480038,462478,17561,942368,N,NULL,9,5/10/2020,NULL
238491,165450,23,28/08/2022,954147,480038,468259,11780,474109,N,NULL,9,5/10/2020,NULL
238492,165450,24,28/09/2022,480035,480038,474109,5926,0,N,NULL,9,5/10/2020,NULL
238493,165451,1,30/10/2020,3037500,622686,585186,37500,2414814,Y,30/10/2020,9,5/10/2020,274038
238494,165451,2,30/11/2020,2444999,622686,592501,30185,1822313,Y,30/11/2020,9,5/10/2020,275385
238495,165451,3,30/12/2020,1845092,622686,599907,22779,1222406,N,NULL,9,5/10/2020,NULL
238496,165451,4,30/01/2021,1237686,622686,607406,15280,615000,N,NULL,9,5/10/2020,NULL
238497,165451,5,28/02/2021,622687,622686,615000,7687,0,N,NULL,9,5/10/2020,NULL
238498,165452,1,30/10/2020,6581250,768109,686859,81250,5813141,Y,30/10/2020,9,5/10/2020,274037
238499,165452,2,30/11/2020,5885806,768109,695444,72664,5117697,Y,30/11/2020,9,5/10/2020,275384
238500,165452,3,30/12/2020,5181669,768109,704137,63971,4413560,N,NULL,9,5/10/2020,NULL
238501,165452,4,30/01/2021,4468730,768109,712939,55169,3700621,N,NULL,9,5/10/2020,NULL
238502,165452,5,28/02/2021,3746879,768109,721851,46258,2978770,N,NULL,9,5/10/2020,NULL
238503,165452,6,28/03/2021,3016005,768109,730874,37235,2247896,N,NULL,9,5/10/2020,NULL
238504,165452,7,28/04/2021,2275995,768109,740010,28099,1507886,N,NULL,9,5/10/2020,NULL
238505,165452,8,28/05/2021,1526735,768109,749260,18849,758626,N,NULL,9,5/10/2020,NULL
238506,165452,9,28/06/2021,768109,768109,758626,9483,0,N,NULL,9,5/10/2020,NULL
238507,165453,1,30/10/2020,4050000,830248,780248,50000,3219752,Y,30/10/2020,9,5/10/2020,274036
238508,165453,2,30/11/2020,3259998,830248,790002,40247,2429750,Y,30/11/2020,9,5/10/2020,275383
238509,165453,3,30/12/2020,2460121,830248,799877,30372,1629873,N,NULL,9,5/10/2020,NULL
238510,165453,4,30/01/2021,1650246,830248,809875,20373,819998,N,NULL,9,5/10/2020,NULL
238511,165453,5,28/02/2021,830248,830248,819998,10250,0,N,NULL,9,5/10/2020,NULL
238512,165454,1,30/10/2020,1318417,445669,427252,18417,872748,Y,30/10/2020,9,5/10/2020,274035
238513,165454,2,30/11/2020,885112,445669,433305,12364,439443,Y,30/11/2020,9,5/10/2020,275382
238514,165454,3,30/12/2020,445669,445669,439443,6225,0,N,NULL,9,5/10/2020,NULL
238515,165455,1,30/10/2020,9186698,818939,705523,113416,8367759,Y,30/10/2020,9,5/10/2020,274034
238516,165455,2,30/11/2020,8472356,818939,714342,104597,7653417,Y,30/11/2020,9,5/10/2020,275381
238517,165455,3,30/12/2020,7749085,818939,723271,95668,6930146,N,NULL,9,5/10/2020,NULL
238518,165455,4,30/01/2021,7016773,818939,732312,86627,6197834,N,NULL,9,5/10/2020,NULL
238519,165455,5,28/02/2021,6275307,818939,741466,77473,5456368,N,NULL,9,5/10/2020,NULL
238520,165455,6,28/03/2021,5524572,818939,750735,68205,4705633,N,NULL,9,5/10/2020,NULL
238521,165455,7,28/04/2021,4764453,818939,760119,58820,3945514,N,NULL,9,5/10/2020,NULL
238522,165455,8,28/05/2021,3994833,818939,769620,49319,3175894,N,NULL,9,5/10/2020,NULL
238523,165455,9,28/06/2021,3215593,818939,779240,39699,2396654,N,NULL,9,5/10/2020,NULL
238524,165455,10,28/07/2021,2426612,818939,788981,29958,1607673,N,NULL,9,5/10/2020,NULL
238525,165455,11,28/08/2021,1627769,818939,798843,20096,808830,N,NULL,9,5/10/2020,NULL
238526,165455,12,28/09/2021,818940,818939,808830,10110,0,N,NULL,9,5/10/2020,NULL
238527,165456,1,30/10/2020,1518750,764092,745342,18750,754658,Y,30/10/2020,9,5/10/2020,274033
238528,165456,2,30/11/2020,764092,764092,754658,9433,0,Y,30/11/2020,9,5/10/2020,275380
238529,165457,1,30/10/2020,7290054,249592,159592,90001,7040462,Y,30/10/2020,9,5/10/2020,274032
238530,165457,2,30/11/2020,7128468,249592,161586,88006,6878876,Y,30/11/2020,9,5/10/2020,275379
238531,165457,3,30/12/2020,6964862,249592,163606,85986,6715270,N,NULL,9,5/10/2020,NULL
238532,165457,4,30/01/2021,6799211,249592,165651,83941,6549619,N,NULL,9,5/10/2020,NULL
238533,165457,5,28/02/2021,6631489,249592,167722,81870,6381897,N,NULL,9,5/10/2020,NULL
238534,165457,6,28/03/2021,6461670,249592,169819,79774,6212078,N,NULL,9,5/10/2020,NULL
238535,165457,7,28/04/2021,6289729,249592,171941,77651,6040137,N,NULL,9,5/10/2020,NULL
238536,165457,8,28/05/2021,6115638,249592,174091,75502,5866046,N,NULL,9,5/10/2020,NULL
238537,165457,9,28/06/2021,5939371,249592,176267,73326,5689779,N,NULL,9,5/10/2020,NULL
238538,165457,10,28/07/2021,5760901,249592,178470,71122,5511309,N,NULL,9,5/10/2020,NULL
238539,165457,11,28/08/2021,5580200,249592,180701,68891,5330608,N,NULL,9,5/10/2020,NULL
238540,165457,12,28/09/2021,5397240,249592,182960,66633,5147648,N,NULL,9,5/10/2020,NULL
238541,165457,13,28/10/2021,5211993,249592,185247,64346,4962401,N,NULL,9,5/10/2020,NULL
238542,165457,14,28/11/2021,5024431,249592,187562,62030,4774839,N,NULL,9,5/10/2020,NULL
238543,165457,15,28/12/2021,4834524,249592,189907,59685,4584932,N,NULL,9,5/10/2020,NULL
238544,165457,16,28/01/2022,4642243,249592,192281,57312,4392651,N,NULL,9,5/10/2020,NULL
238545,165457,17,28/02/2022,4447559,249592,194684,54908,4197967,N,NULL,9,5/10/2020,NULL
238546,165457,18,28/03/2022,4250441,249592,197118,52475,4000849,N,NULL,9,5/10/2020,NULL
238547,165457,19,28/04/2022,4050859,249592,199582,50011,3801267,N,NULL,9,5/10/2020,NULL
238548,165457,20,28/05/2022,3848783,249592,202076,47516,3599191,N,NULL,9,5/10/2020,NULL
238549,165457,21,28/06/2022,3644181,249592,204602,44990,3394589,N,NULL,9,5/10/2020,NULL
238550,165457,22,28/07/2022,3437021,249592,207160,42432,3187429,N,NULL,9,5/10/2020,NULL
238551,165457,23,28/08/2022,3227272,249592,209749,39843,2977680,N,NULL,9,5/10/2020,NULL
238552,165457,24,28/09/2022,3014901,249592,212371,37221,2765309,N,NULL,9,5/10/2020,NULL
238553,165457,25,28/10/2022,2799875,249592,215026,34566,2550283,N,NULL,9,5/10/2020,NULL
238554,165457,26,28/11/2022,2582161,249592,217714,31879,2332569,N,NULL,9,5/10/2020,NULL
238555,165457,27,28/12/2022,2361726,249592,220435,29157,2112134,N,NULL,9,5/10/2020,NULL
238556,165457,28,28/01/2023,2138535,249592,223191,26402,1888943,N,NULL,9,5/10/2020,NULL
238557,165457,29,28/02/2023,1912555,249592,225980,23612,1662963,N,NULL,9,5/10/2020,NULL
238558,165457,30,28/03/2023,1683750,249592,228805,20787,1434158,N,NULL,9,5/10/2020,NULL
238559,165457,31,28/04/2023,1452085,249592,231665,17927,1202493,N,NULL,9,5/10/2020,NULL
238560,165457,32,28/05/2023,1217524,249592,234561,15031,967932,N,NULL,9,5/10/2020,NULL
238561,165457,33,28/06/2023,980031,249592,237493,12099,730439,N,NULL,9,5/10/2020,NULL
238562,165457,34,28/07/2023,739569,249592,240462,9131,489977,N,NULL,9,5/10/2020,NULL
238563,165457,35,28/08/2023,496101,249592,243468,6125,246509,N,NULL,9,5/10/2020,NULL
238564,165457,36,28/09/2023,249590,249592,246509,3081,0,N,NULL,9,5/10/2020,NULL
238565,165458,1,30/10/2020,10125000,237899,112899,125000,9887101,Y,30/10/2020,9,5/10/2020,274031
238566,165458,2,30/11/2020,10010689,237899,114311,123589,9772790,Y,30/11/2020,9,5/10/2020,275378
238567,165458,3,30/12/2020,9894950,237899,115739,122160,9657051,N,NULL,9,5/10/2020,NULL
238568,165458,4,30/01/2021,9777764,237899,117186,120713,9539865,N,NULL,9,5/10/2020,NULL
238569,165458,5,28/02/2021,9659113,237899,118651,119248,9421214,N,NULL,9,5/10/2020,NULL
238570,165458,6,28/03/2021,9538979,237899,120134,117765,9301080,N,NULL,9,5/10/2020,NULL
238571,165458,7,28/04/2021,9417343,237899,121636,116263,9179444,N,NULL,9,5/10/2020,NULL
238572,165458,8,28/05/2021,9294187,237899,123156,114743,9056288,N,NULL,9,5/10/2020,NULL
238573,165458,9,28/06/2021,9169491,237899,124696,113204,8931592,N,NULL,9,5/10/2020,NULL
238574,165458,10,28/07/2021,9043237,237899,126254,111645,8805338,N,NULL,9,5/10/2020,NULL
238575,165458,11,28/08/2021,8915404,237899,127833,110067,8677505,N,NULL,9,5/10/2020,NULL
238576,165458,12,28/09/2021,8785974,237899,129430,108469,8548075,N,NULL,9,5/10/2020,NULL
238577,165458,13,28/10/2021,8654926,237899,131048,106851,8417027,N,NULL,9,5/10/2020,NULL
238578,165458,14,28/11/2021,8522240,237899,132686,105213,8284341,N,NULL,9,5/10/2020,NULL
238579,165458,15,28/12/2021,8387895,237899,134345,103554,8149996,N,NULL,9,5/10/2020,NULL
238580,165458,16,28/01/2022,8251871,237899,136024,101875,8013972,N,NULL,9,5/10/2020,NULL
238581,165458,17,28/02/2022,8114146,237899,137725,100175,7876247,N,NULL,9,5/10/2020,NULL
238582,165458,18,28/03/2022,7974700,237899,139446,98453,7736801,N,NULL,9,5/10/2020,NULL
238583,165458,19,28/04/2022,7833511,237899,141189,96710,7595612,N,NULL,9,5/10/2020,NULL
238584,165458,20,28/05/2022,7690557,237899,142954,94945,7452658,N,NULL,9,5/10/2020,NULL
238585,165458,21,28/06/2022,7545816,237899,144741,93158,7307917,N,NULL,9,5/10/2020,NULL
238586,165458,22,28/07/2022,7399266,237899,146550,91349,7161367,N,NULL,9,5/10/2020,NULL
238587,165458,23,28/08/2022,7250884,237899,148382,89517,7012985,N,NULL,9,5/10/2020,NULL
238588,165458,24,28/09/2022,7100647,237899,150237,87662,6862748,N,NULL,9,5/10/2020,NULL
238589,165458,25,28/10/2022,6948532,237899,152115,85784,6710633,N,NULL,9,5/10/2020,NULL
238590,165458,26,28/11/2022,6794516,237899,154016,83883,6556617,N,NULL,9,5/10/2020,NULL
238591,165458,27,28/12/2022,6638574,237899,155942,81958,6400675,N,NULL,9,5/10/2020,NULL
238592,165458,28,28/01/2023,6480683,237899,157891,80008,6242784,N,NULL,9,5/10/2020,NULL
238593,165458,29,28/02/2023,6320818,237899,159865,78035,6082919,N,NULL,9,5/10/2020,NULL
238594,165458,30,28/03/2023,6158955,237899,161863,76036,5921056,N,NULL,9,5/10/2020,NULL
238595,165458,31,28/04/2023,5995069,237899,163886,74013,5757170,N,NULL,9,5/10/2020,NULL
238596,165458,32,28/05/2023,5829134,237899,165935,71965,5591235,N,NULL,9,5/10/2020,NULL
238597,165458,33,28/06/2023,5661125,237899,168009,69890,5423226,N,NULL,9,5/10/2020,NULL
238598,165458,34,28/07/2023,5491016,237899,170109,67790,5253117,N,NULL,9,5/10/2020,NULL
238599,165458,35,28/08/2023,5318781,237899,172235,65664,5080882,N,NULL,9,5/10/2020,NULL
238600,165458,36,28/09/2023,5144393,237899,174388,63511,4906494,N,NULL,9,5/10/2020,NULL
238601,165458,37,28/10/2023,4967825,237899,176568,61331,4729926,N,NULL,9,5/10/2020,NULL
238602,165458,38,28/11/2023,4789050,237899,178775,59124,4551151,N,NULL,9,5/10/2020,NULL
238603,165458,39,28/12/2023,4608040,237899,181010,56889,4370141,N,NULL,9,5/10/2020,NULL
238604,165458,40,28/01/2024,4424767,237899,183273,54627,4186868,N,NULL,9,5/10/2020,NULL
238605,165458,41,28/02/2024,4239204,237899,185563,52336,4001305,N,NULL,9,5/10/2020,NULL
238606,165458,42,28/03/2024,4051321,237899,187883,50016,3813422,N,NULL,9,5/10/2020,NULL
238607,165458,43,28/04/2024,3861089,237899,190232,47668,3623190,N,NULL,9,5/10/2020,NULL
238608,165458,44,28/05/2024,3668480,237899,192609,45290,3430581,N,NULL,9,5/10/2020,NULL
238609,165458,45,28/06/2024,3473463,237899,195017,42882,3235564,N,NULL,9,5/10/2020,NULL
238610,165458,46,28/07/2024,3276008,237899,197455,40445,3038109,N,NULL,9,5/10/2020,NULL
238611,165458,47,28/08/2024,3076085,237899,199923,37976,2838186,N,NULL,9,5/10/2020,NULL
238612,165458,48,28/09/2024,2873663,237899,202422,35477,2635764,N,NULL,9,5/10/2020,NULL
238613,165458,49,28/10/2024,2668711,237899,204952,32947,2430812,N,NULL,9,5/10/2020,NULL
238614,165458,50,28/11/2024,2461197,237899,207514,30385,2223298,N,NULL,9,5/10/2020,NULL
238615,165458,51,28/12/2024,2251089,237899,210108,27791,2013190,N,NULL,9,5/10/2020,NULL
238616,165458,52,28/01/2025,2038355,237899,212734,25165,1800456,N,NULL,9,5/10/2020,NULL
238617,165458,53,28/02/2025,1822961,237899,215394,22506,1585062,N,NULL,9,5/10/2020,NULL
238618,165458,54,28/03/2025,1604875,237899,218086,19813,1366976,N,NULL,9,5/10/2020,NULL
238619,165458,55,28/04/2025,1384063,237899,220812,17087,1146164,N,NULL,9,5/10/2020,NULL
238620,165458,56,28/05/2025,1160491,237899,223572,14327,922592,N,NULL,9,5/10/2020,NULL
238621,165458,57,28/06/2025,934124,237899,226367,11532,696225,N,NULL,9,5/10/2020,NULL
238622,165458,58,28/07/2025,704927,237899,229197,8703,467028,N,NULL,9,5/10/2020,NULL
238623,165458,59,28/08/2025,472865,237899,232062,5838,234966,N,NULL,9,5/10/2020,NULL
238624,165458,60,28/09/2025,237903,237899,234966,2937,0,N,NULL,9,5/10/2020,NULL
238625,165459,1,1/11/2020,53920688,1266933,601245,665688,52653755,Y,1/11/2020,9,5/10/2020,274069
238626,165459,2,1/12/2020,53311927,1266933,608761,658172,52044994,Y,1/12/2020,9,5/10/2020,275448
238627,165459,3,11/12/2020,52695557,1266933,616370,650562,51428624,C,11/12/2020,9,5/10/2020,NULL
238628,165459,4,11/12/2020,52071482,1266933,624075,0,50804549,C,11/12/2020,9,5/10/2020,NULL
238629,165459,5,11/12/2020,51439606,1266933,631876,0,50172673,C,11/12/2020,9,5/10/2020,NULL
238630,165459,6,11/12/2020,50799832,1266933,639774,0,49532899,C,11/12/2020,9,5/10/2020,NULL
238631,165459,7,11/12/2020,50152061,1266933,647771,0,48885128,C,11/12/2020,9,5/10/2020,NULL
238632,165459,8,11/12/2020,49496192,1266933,655869,0,48229259,C,11/12/2020,9,5/10/2020,NULL
238633,165459,9,11/12/2020,48832125,1266933,664067,0,47565192,C,11/12/2020,9,5/10/2020,NULL
238634,165459,10,11/12/2020,48159757,1266933,672368,0,46892824,C,11/12/2020,9,5/10/2020,NULL
238635,165459,11,11/12/2020,47478985,1266933,680772,0,46212052,C,11/12/2020,9,5/10/2020,NULL
238636,165459,12,11/12/2020,46789703,1266933,689282,0,45522770,C,11/12/2020,9,5/10/2020,NULL
238637,165459,13,11/12/2020,46091805,1266933,697898,0,44824872,C,11/12/2020,9,5/10/2020,NULL
238638,165459,14,11/12/2020,45385183,1266933,706622,0,44118250,C,11/12/2020,9,5/10/2020,NULL
238639,165459,15,11/12/2020,44669728,1266933,715455,0,43402795,C,11/12/2020,9,5/10/2020,NULL
238640,165459,16,11/12/2020,43945330,1266933,724398,0,42678397,C,11/12/2020,9,5/10/2020,NULL
238641,165459,17,11/12/2020,43211877,1266933,733453,0,41944944,C,11/12/2020,9,5/10/2020,NULL
238642,165459,18,11/12/2020,42469256,1266933,742621,0,41202323,C,11/12/2020,9,5/10/2020,NULL
238643,165459,19,11/12/2020,41717352,1266933,751904,0,40450419,C,11/12/2020,9,5/10/2020,NULL
238644,165459,20,11/12/2020,40956050,1266933,761302,0,39689117,C,11/12/2020,9,5/10/2020,NULL
238645,165459,21,11/12/2020,40185231,1266933,770819,0,38918298,C,11/12/2020,9,5/10/2020,NULL
238646,165459,22,11/12/2020,39404777,1266933,780454,0,38137844,C,11/12/2020,9,5/10/2020,NULL
238647,165459,23,11/12/2020,38614567,1266933,790210,0,37347634,C,11/12/2020,9,5/10/2020,NULL
238648,165459,24,11/12/2020,37814480,1266933,800087,0,36547547,C,11/12/2020,9,5/10/2020,NULL
238649,165459,25,11/12/2020,37004392,1266933,810088,0,35737459,C,11/12/2020,9,5/10/2020,NULL
238650,165459,26,11/12/2020,36184178,1266933,820214,0,34917245,C,11/12/2020,9,5/10/2020,NULL
238651,165459,27,11/12/2020,35353711,1266933,830467,0,34086778,C,11/12/2020,9,5/10/2020,NULL
238652,165459,28,11/12/2020,34512863,1266933,840848,0,33245930,C,11/12/2020,9,5/10/2020,NULL
238653,165459,29,11/12/2020,33661504,1266933,851359,0,32394571,C,11/12/2020,9,5/10/2020,NULL
238654,165459,30,11/12/2020,32799503,1266933,862001,0,31532570,C,11/12/2020,9,5/10/2020,NULL
238655,165459,31,11/12/2020,31926727,1266933,872776,0,30659794,C,11/12/2020,9,5/10/2020,NULL
238656,165459,32,11/12/2020,31043042,1266933,883685,0,29776109,C,11/12/2020,9,5/10/2020,NULL
238657,165459,33,11/12/2020,30148311,1266933,894731,0,28881378,C,11/12/2020,9,5/10/2020,NULL
238658,165459,34,11/12/2020,29242395,1266933,905916,0,27975462,C,11/12/2020,9,5/10/2020,NULL
238659,165459,35,11/12/2020,28325156,1266933,917239,0,27058223,C,11/12/2020,9,5/10/2020,NULL
238660,165459,36,11/12/2020,27396451,1266933,928705,0,26129518,C,11/12/2020,9,5/10/2020,NULL
238661,165459,37,11/12/2020,26456137,1266933,940314,0,25189204,C,11/12/2020,9,5/10/2020,NULL
238662,165459,38,11/12/2020,25504069,1266933,952068,0,24237136,C,11/12/2020,9,5/10/2020,NULL
238663,165459,39,11/12/2020,24540100,1266933,963969,0,23273167,C,11/12/2020,9,5/10/2020,NULL
238664,165459,40,11/12/2020,23564082,1266933,976018,0,22297149,C,11/12/2020,9,5/10/2020,NULL
238665,165459,41,11/12/2020,22575864,1266933,988218,0,21308931,C,11/12/2020,9,5/10/2020,NULL
238666,165459,42,11/12/2020,21575293,1266933,1000571,0,20308360,C,11/12/2020,9,5/10/2020,NULL
238667,165459,43,11/12/2020,20562215,1266933,1013078,0,19295282,C,11/12/2020,9,5/10/2020,NULL
238668,165459,44,11/12/2020,19536473,1266933,1025742,0,18269540,C,11/12/2020,9,5/10/2020,NULL
238669,165459,45,11/12/2020,18497910,1266933,1038563,0,17230977,C,11/12/2020,9,5/10/2020,NULL
238670,165459,46,11/12/2020,17446364,1266933,1051546,0,16179431,C,11/12/2020,9,5/10/2020,NULL
238671,165459,47,11/12/2020,16381674,1266933,1064690,0,15114741,C,11/12/2020,9,5/10/2020,NULL
238672,165459,48,11/12/2020,15303676,1266933,1077998,0,14036743,C,11/12/2020,9,5/10/2020,NULL
238673,165459,49,11/12/2020,14212203,1266933,1091473,0,12945270,C,11/12/2020,9,5/10/2020,NULL
238674,165459,50,11/12/2020,13107086,1266933,1105117,0,11840153,C,11/12/2020,9,5/10/2020,NULL
238675,165459,51,11/12/2020,11988155,1266933,1118931,0,10721222,C,11/12/2020,9,5/10/2020,NULL
238676,165459,52,11/12/2020,10855238,1266933,1132917,0,9588305,C,11/12/2020,9,5/10/2020,NULL
238677,165459,53,11/12/2020,9708159,1266933,1147079,0,8441226,C,11/12/2020,9,5/10/2020,NULL
238678,165459,54,11/12/2020,8546742,1266933,1161417,0,7279809,C,11/12/2020,9,5/10/2020,NULL
238679,165459,55,11/12/2020,7370807,1266933,1175935,0,6103874,C,11/12/2020,9,5/10/2020,NULL
238680,165459,56,11/12/2020,6180173,1266933,1190634,0,4913240,C,11/12/2020,9,5/10/2020,NULL
238681,165459,57,11/12/2020,4974656,1266933,1205517,0,3707723,C,11/12/2020,9,5/10/2020,NULL
238682,165459,58,11/12/2020,3754070,1266933,1220586,0,2487137,C,11/12/2020,9,5/10/2020,NULL
238683,165459,59,11/12/2020,2518226,1266933,1235844,0,1251293,C,11/12/2020,9,5/10/2020,NULL
238684,165459,60,11/12/2020,1266934,1266933,1251293,0,0,C,11/12/2020,9,5/10/2020,NULL
238685,165460,1,1/11/2020,33239061,6813995,6403636,410359,26425066,Y,1/11/2020,9,5/10/2020,274068
238686,165460,2,1/12/2020,26755380,6813995,6483681,330313,19941385,Y,1/12/2020,9,5/10/2020,275447
238687,165460,3,1/1/2021,20190653,6813995,6564727,249267,13376658,N,NULL,9,5/10/2020,NULL
238688,165460,4,1/2/2021,13543867,6813995,6646786,167208,6729872,N,NULL,9,5/10/2020,NULL
238689,165460,5,1/3/2021,6813996,6813995,6729872,84123,0,N,NULL,9,5/10/2020,NULL
238690,165461,1,2/11/2020,3042500,1028466,985966,42500,2014034,Y,2/11/2020,9,6/10/2020,274080
238691,165461,2,2/12/2020,2042566,1028466,999934,28532,1014100,Y,2/12/2020,9,6/10/2020,275543
238692,165461,3,2/1/2021,1028466,1028466,1014100,14366,0,N,NULL,9,6/10/2020,NULL
238693,165462,1,2/11/2020,938841,472336,460745,11591,466505,Y,2/11/2020,9,6/10/2020,274079
238694,165462,2,2/12/2020,472336,472336,466505,5831,0,Y,2/12/2020,9,6/10/2020,275542
238695,165463,1,1/11/2020,6075000,1044203,969203,75000,5030797,Y,1/11/2020,9,6/10/2020,274067
238696,165463,2,1/12/2020,5093682,1044203,981318,62885,4049479,Y,1/12/2020,9,6/10/2020,275446
238697,165463,3,1/1/2021,4100098,1044203,993584,50618,3055895,N,NULL,9,6/10/2020,NULL
238698,165463,4,1/2/2021,3094094,1044203,1006004,38199,2049891,N,NULL,9,6/10/2020,NULL
238699,165463,5,1/3/2021,2075515,1044203,1018579,25624,1031312,N,NULL,9,6/10/2020,NULL
238700,165463,6,1/4/2021,1044204,1044203,1031312,12891,0,N,NULL,9,6/10/2020,NULL
238701,165464,1,5/11/2020,6017381,1034299,960010,74289,4983082,Y,5/11/2020,9,6/10/2020,274252
238702,165464,2,5/12/2020,5045371,1034299,972010,62289,4011072,Y,5/12/2020,9,6/10/2020,275839
238703,165464,3,5/1/2021,4061210,1034299,984161,50138,3026911,N,NULL,9,6/10/2020,NULL
238704,165464,4,5/2/2021,3064747,1034299,996463,37836,2030448,N,NULL,9,6/10/2020,NULL
238705,165464,5,5/3/2021,2055829,1034299,1008918,25381,1021530,N,NULL,9,6/10/2020,NULL
238706,165464,6,5/4/2021,1034299,1034299,1021530,12769,0,N,NULL,9,6/10/2020,NULL
238707,165465,1,6/11/2020,1822500,464150,441650,22500,1358350,Y,6/11/2020,9,8/10/2020,274324
238708,165465,2,6/12/2020,1375330,464150,447170,16979,911180,Y,6/12/2020,9,8/10/2020,275860
238709,165465,3,6/1/2021,922570,464150,452760,11390,458420,N,NULL,9,8/10/2020,NULL
238710,165465,4,6/2/2021,464150,464150,458420,5730,0,N,NULL,9,8/10/2020,NULL
238711,165466,1,6/11/2020,9751989,600865,480470,120395,9151124,Y,6/11/2020,9,8/10/2020,274323
238712,165466,2,6/12/2020,9265513,600865,486476,114389,8664648,Y,6/12/2020,9,8/10/2020,275859
238713,165466,3,6/1/2021,8772956,600865,492557,108308,8172091,N,NULL,9,8/10/2020,NULL
238714,165466,4,6/2/2021,8274242,600865,498714,102151,7673377,N,NULL,9,8/10/2020,NULL
238715,165466,5,6/3/2021,7769294,600865,504948,95917,7168429,N,NULL,9,8/10/2020,NULL
238716,165466,6,6/4/2021,7258034,600865,511260,89605,6657169,N,NULL,9,8/10/2020,NULL
238717,165466,7,6/5/2021,6740384,600865,517650,83215,6139519,N,NULL,9,8/10/2020,NULL
238718,165466,8,6/6/2021,6216263,600865,524121,76744,5615398,N,NULL,9,8/10/2020,NULL
238719,165466,9,6/7/2021,5685591,600865,530672,70192,5084726,N,NULL,9,8/10/2020,NULL
238720,165466,10,6/8/2021,5148285,600865,537306,63559,4547420,N,NULL,9,8/10/2020,NULL
238721,165466,11,6/9/2021,4604263,600865,544022,56843,4003398,N,NULL,9,8/10/2020,NULL
238722,165466,12,6/10/2021,4053441,600865,550822,50042,3452576,N,NULL,9,8/10/2020,NULL
238723,165466,13,6/11/2021,3495733,600865,557708,43157,2894868,N,NULL,9,8/10/2020,NULL
238724,165466,14,6/12/2021,2931054,600865,564679,36186,2330189,N,NULL,9,8/10/2020,NULL
238725,165466,15,6/1/2022,2359316,600865,571738,29127,1758451,N,NULL,9,8/10/2020,NULL
238726,165466,16,6/2/2022,1780432,600865,578884,21981,1179567,N,NULL,9,8/10/2020,NULL
238727,165466,17,6/3/2022,1194312,600865,586120,14745,593447,N,NULL,9,8/10/2020,NULL
238728,165466,18,6/4/2022,600865,600865,593447,7418,0,N,NULL,9,8/10/2020,NULL
238849,165468,1,6/11/2020,5062500,451292,388792,62500,4611208,Y,6/11/2020,9,8/10/2020,274322
238850,165468,2,6/12/2020,4668849,451292,393651,57640,4217557,Y,6/12/2020,9,8/10/2020,275858
238851,165468,3,6/1/2021,4270277,451292,398572,52719,3818985,N,NULL,9,8/10/2020,NULL
238852,165468,4,6/2/2021,3866723,451292,403554,47737,3415431,N,NULL,9,8/10/2020,NULL
238853,165468,5,6/3/2021,3458124,451292,408599,42693,3006832,N,NULL,9,8/10/2020,NULL
238854,165468,6,6/4/2021,3044418,451292,413706,37585,2593126,N,NULL,9,8/10/2020,NULL
238855,165468,7,6/5/2021,2625541,451292,418877,32414,2174249,N,NULL,9,8/10/2020,NULL
238856,165468,8,6/6/2021,2201428,451292,424113,27178,1750136,N,NULL,9,8/10/2020,NULL
238857,165468,9,6/7/2021,1772013,451292,429415,21877,1320721,N,NULL,9,8/10/2020,NULL
238858,165468,10,6/8/2021,1337230,451292,434783,16509,885938,N,NULL,9,8/10/2020,NULL
238859,165468,11,6/9/2021,897013,451292,440217,11074,445721,N,NULL,9,8/10/2020,NULL
238860,165468,12,6/10/2021,451293,451292,445721,5572,0,N,NULL,9,8/10/2020,NULL
238861,165469,1,6/11/2020,7340930,654400,563771,90629,6686530,Y,6/11/2020,9,8/10/2020,274321
238862,165469,2,6/12/2020,6770112,654400,570818,83582,6115712,Y,6/12/2020,9,8/10/2020,275857
238863,165469,3,6/1/2021,6192158,654400,577954,76446,5537758,N,NULL,9,8/10/2020,NULL
238864,165469,4,6/2/2021,5606980,654400,585178,69222,4952580,N,NULL,9,8/10/2020,NULL
238865,165469,5,6/3/2021,5014487,654400,592493,61907,4360087,N,NULL,9,8/10/2020,NULL
238866,165469,6,6/4/2021,4414588,654400,599899,54501,3760188,N,NULL,9,8/10/2020,NULL
238867,165469,7,6/5/2021,3807190,654400,607398,47002,3152790,N,NULL,9,8/10/2020,NULL
238868,165469,8,6/6/2021,3192200,654400,614990,39410,2537800,N,NULL,9,8/10/2020,NULL
238869,165469,9,6/7/2021,2569523,654400,622677,31723,1915123,N,NULL,9,8/10/2020,NULL
238870,165469,10,6/8/2021,1939062,654400,630461,23939,1284662,N,NULL,9,8/10/2020,NULL
238871,165469,11,6/9/2021,1300720,654400,638342,16058,646320,N,NULL,9,8/10/2020,NULL
238872,165469,12,6/10/2021,654399,654400,646320,8079,0,N,NULL,9,8/10/2020,NULL
238873,165470,1,6/11/2020,28350000,970629,620629,350000,27379371,Y,6/11/2020,9,8/10/2020,274320
238874,165470,2,24/11/2020,27721613,970629,628387,342242,26750984,Y,24/11/2020,9,8/10/2020,275078
238875,165470,3,6/1/2021,27085371,970629,636242,334387,26114742,R,NULL,9,8/10/2020,NULL
238876,165470,4,6/2/2021,26441176,970629,644195,326434,25470547,R,NULL,9,8/10/2020,NULL
238877,165470,5,6/3/2021,25788929,970629,652247,318382,24818300,R,NULL,9,8/10/2020,NULL
238878,165470,6,6/4/2021,25128529,970629,660400,310229,24157900,R,NULL,9,8/10/2020,NULL
238879,165470,7,6/5/2021,24459874,970629,668655,301974,23489245,R,NULL,9,8/10/2020,NULL
238880,165470,8,6/6/2021,23782860,970629,677014,293616,22812231,R,NULL,9,8/10/2020,NULL
238881,165470,9,6/7/2021,23097384,970629,685476,285153,22126755,R,NULL,9,8/10/2020,NULL
238882,165470,10,6/8/2021,22403339,970629,694045,276584,21432710,R,NULL,9,8/10/2020,NULL
238883,165470,11,6/9/2021,21700619,970629,702720,267909,20729990,R,NULL,9,8/10/2020,NULL
238884,165470,12,6/10/2021,20989115,970629,711504,259125,20018486,R,NULL,9,8/10/2020,NULL
238885,165470,13,6/11/2021,20268717,970629,720398,250231,19298088,R,NULL,9,8/10/2020,NULL
238886,165470,14,6/12/2021,19539314,970629,729403,241226,18568685,R,NULL,9,8/10/2020,NULL
238887,165470,15,6/1/2022,18800793,970629,738521,232109,17830164,R,NULL,9,8/10/2020,NULL
238888,165470,16,6/2/2022,18053041,970629,747752,222877,17082412,R,NULL,9,8/10/2020,NULL
238889,165470,17,6/3/2022,17295942,970629,757099,213530,16325313,R,NULL,9,8/10/2020,NULL
238890,165470,18,6/4/2022,16529379,970629,766563,204066,15558750,R,NULL,9,8/10/2020,NULL
238891,165470,19,6/5/2022,15753234,970629,776145,194484,14782605,R,NULL,9,8/10/2020,NULL
238892,165470,20,6/6/2022,14967387,970629,785847,184783,13996758,R,NULL,9,8/10/2020,NULL
238893,165470,21,6/7/2022,14171717,970629,795670,174959,13201088,R,NULL,9,8/10/2020,NULL
238894,165470,22,6/8/2022,13366101,970629,805616,165014,12395472,R,NULL,9,8/10/2020,NULL
238895,165470,23,6/9/2022,12550415,970629,815686,154943,11579786,R,NULL,9,8/10/2020,NULL
238896,165470,24,6/10/2022,11724533,970629,825882,144747,10753904,R,NULL,9,8/10/2020,NULL
238897,165470,25,6/11/2022,10888328,970629,836205,134424,9917699,R,NULL,9,8/10/2020,NULL
238898,165470,26,6/12/2022,10041670,970629,846658,123971,9071041,R,NULL,9,8/10/2020,NULL
238899,165470,27,6/1/2023,9184429,970629,857241,113388,8213800,R,NULL,9,8/10/2020,NULL
238900,165470,28,6/2/2023,8316472,970629,867957,102672,7345843,R,NULL,9,8/10/2020,NULL
238901,165470,29,6/3/2023,7437666,970629,878806,91823,6467037,R,NULL,9,8/10/2020,NULL
238902,165470,30,6/4/2023,6547875,970629,889791,80838,5577246,R,NULL,9,8/10/2020,NULL
238903,165470,31,6/5/2023,5646961,970629,900914,69716,4676332,R,NULL,9,8/10/2020,NULL
238904,165470,32,6/6/2023,4734786,970629,912175,58454,3764157,R,NULL,9,8/10/2020,NULL
238905,165470,33,6/7/2023,3811209,970629,923577,47052,2840580,R,NULL,9,8/10/2020,NULL
238906,165470,34,6/8/2023,2876087,970629,935122,35507,1905458,R,NULL,9,8/10/2020,NULL
238907,165470,35,24/11/2020,1929276,970629,946811,0,958647,Y,24/11/2020,9,8/10/2020,275079
238908,165470,36,24/11/2020,970630,970629,958647,0,0,Y,24/11/2020,9,8/10/2020,275080
238909,165471,1,6/11/2020,28350000,666118,316118,350000,27683882,Y,6/11/2020,9,8/10/2020,274319
238910,165471,2,6/12/2020,28029930,666118,320070,346049,27363812,Y,6/12/2020,9,8/10/2020,275856
238911,165471,3,6/1/2021,27705860,666118,324070,342048,27039742,N,NULL,9,8/10/2020,NULL
238912,165471,4,6/2/2021,27377739,666118,328121,337997,26711621,N,NULL,9,8/10/2020,NULL
238913,165471,5,6/3/2021,27045516,666118,332223,333895,26379398,N,NULL,9,8/10/2020,NULL
238914,165471,6,6/4/2021,26709140,666118,336376,329742,26043022,N,NULL,9,8/10/2020,NULL
238915,165471,7,6/5/2021,26368560,666118,340580,325538,25702442,N,NULL,9,8/10/2020,NULL
238916,165471,8,6/6/2021,26023722,666118,344838,321281,25357604,N,NULL,9,8/10/2020,NULL
238917,165471,9,6/7/2021,25674574,666118,349148,316970,25008456,N,NULL,9,8/10/2020,NULL
238918,165471,10,6/8/2021,25321062,666118,353512,312606,24654944,N,NULL,9,8/10/2020,NULL
238919,165471,11,6/9/2021,24963131,666118,357931,308187,24297013,N,NULL,9,8/10/2020,NULL
238920,165471,12,6/10/2021,24600726,666118,362405,303713,23934608,N,NULL,9,8/10/2020,NULL
238921,165471,13,6/11/2021,24233791,666118,366935,299183,23567673,N,NULL,9,8/10/2020,NULL
238922,165471,14,6/12/2021,23862269,666118,371522,294596,23196151,N,NULL,9,8/10/2020,NULL
238923,165471,15,6/1/2022,23486103,666118,376166,289952,22819985,N,NULL,9,8/10/2020,NULL
238924,165471,16,6/2/2022,23105235,666118,380868,285250,22439117,N,NULL,9,8/10/2020,NULL
238925,165471,17,6/3/2022,22719606,666118,385629,280489,22053488,N,NULL,9,8/10/2020,NULL
238926,165471,18,6/4/2022,22329157,666118,390449,275669,21663039,N,NULL,9,8/10/2020,NULL
238927,165471,19,6/5/2022,21933827,666118,395330,270788,21267709,N,NULL,9,8/10/2020,NULL
238928,165471,20,6/6/2022,21533555,666118,400272,265846,20867437,N,NULL,9,8/10/2020,NULL
238929,165471,21,6/7/2022,21128280,666118,405275,260843,20462162,N,NULL,9,8/10/2020,NULL
238930,165471,22,6/8/2022,20717939,666118,410341,255777,20051821,N,NULL,9,8/10/2020,NULL
238931,165471,23,6/9/2022,20302469,666118,415470,250648,19636351,N,NULL,9,8/10/2020,NULL
238932,165471,24,6/10/2022,19881805,666118,420664,245454,19215687,N,NULL,9,8/10/2020,NULL
238933,165471,25,6/11/2022,19455883,666118,425922,240196,18789765,N,NULL,9,8/10/2020,NULL
238934,165471,26,6/12/2022,19024637,666118,431246,234872,18358519,N,NULL,9,8/10/2020,NULL
238935,165471,27,6/1/2023,18588000,666118,436637,229481,17921882,N,NULL,9,8/10/2020,NULL
238936,165471,28,6/2/2023,18145905,666118,442095,224024,17479787,N,NULL,9,8/10/2020,NULL
238937,165471,29,6/3/2023,17698284,666118,447621,218497,17032166,N,NULL,9,8/10/2020,NULL
238938,165471,30,6/4/2023,17245068,666118,453216,212902,16578950,N,NULL,9,8/10/2020,NULL
238939,165471,31,6/5/2023,16786187,666118,458881,207237,16120069,N,NULL,9,8/10/2020,NULL
238940,165471,32,6/6/2023,16321570,666118,464617,201501,15655452,N,NULL,9,8/10/2020,NULL
238941,165471,33,6/7/2023,15851145,666118,470425,195693,15185027,N,NULL,9,8/10/2020,NULL
238942,165471,34,6/8/2023,15374840,666118,476305,189813,14708722,N,NULL,9,8/10/2020,NULL
238943,165471,35,6/9/2023,14892581,666118,482259,183859,14226463,N,NULL,9,8/10/2020,NULL
238944,165471,36,6/10/2023,14404294,666118,488287,177831,13738176,N,NULL,9,8/10/2020,NULL
238945,165471,37,6/11/2023,13909903,666118,494391,171727,13243785,N,NULL,9,8/10/2020,NULL
238946,165471,38,6/12/2023,13409332,666118,500571,165547,12743214,N,NULL,9,8/10/2020,NULL
238947,165471,39,6/1/2024,12902504,666118,506828,159290,12236386,N,NULL,9,8/10/2020,NULL
238948,165471,40,6/2/2024,12389341,666118,513163,152955,11723223,N,NULL,9,8/10/2020,NULL
238949,165471,41,6/3/2024,11869763,666118,519578,146540,11203645,N,NULL,9,8/10/2020,NULL
238950,165471,42,6/4/2024,11343691,666118,526072,140046,10677573,N,NULL,9,8/10/2020,NULL
238951,165471,43,6/5/2024,10811043,666118,532648,133470,10144925,N,NULL,9,8/10/2020,NULL
238952,165471,44,6/6/2024,10271736,666118,539307,126812,9605618,N,NULL,9,8/10/2020,NULL
238953,165471,45,6/7/2024,9725688,666118,546048,120070,9059570,N,NULL,9,8/10/2020,NULL
238954,165471,46,6/8/2024,9172815,666118,552873,113245,8506697,N,NULL,9,8/10/2020,NULL
238955,165471,47,6/9/2024,8613031,666118,559784,106334,7946913,N,NULL,9,8/10/2020,NULL
238956,165471,48,6/10/2024,8046249,666118,566782,99336,7380131,N,NULL,9,8/10/2020,NULL
238957,165471,49,6/11/2024,7472383,666118,573866,92252,6806265,N,NULL,9,8/10/2020,NULL
238958,165471,50,6/12/2024,6891343,666118,581040,85078,6225225,N,NULL,9,8/10/2020,NULL
238959,165471,51,6/1/2025,6303040,666118,588303,77815,5636922,N,NULL,9,8/10/2020,NULL
238960,165471,52,6/2/2025,5707383,666118,595657,70462,5041265,N,NULL,9,8/10/2020,NULL
238961,165471,53,6/3/2025,5104281,666118,603102,63016,4438163,N,NULL,9,8/10/2020,NULL
238962,165471,54,6/4/2025,4493640,666118,610641,55477,3827522,N,NULL,9,8/10/2020,NULL
238963,165471,55,6/5/2025,3875366,666118,618274,47844,3209248,N,NULL,9,8/10/2020,NULL
238964,165471,56,6/6/2025,3249364,666118,626002,40116,2583246,N,NULL,9,8/10/2020,NULL
238965,165471,57,6/7/2025,2615537,666118,633827,32291,1949419,N,NULL,9,8/10/2020,NULL
238966,165471,58,6/8/2025,1973787,666118,641750,24368,1307669,N,NULL,9,8/10/2020,NULL
238967,165471,59,6/9/2025,1324015,666118,649772,16346,657897,N,NULL,9,8/10/2020,NULL
238968,165471,60,6/10/2025,666121,666118,657897,8224,0,N,NULL,9,8/10/2020,NULL
238969,165472,1,7/11/2020,5265000,252131,187131,65000,5012869,Y,7/11/2020,9,8/10/2020,274427
238970,165472,2,7/12/2020,5075530,252131,189470,62661,4823399,Y,7/12/2020,9,8/10/2020,275919
238971,165472,3,7/1/2021,4883692,252131,191838,60292,4631561,N,NULL,9,8/10/2020,NULL
238972,165472,4,7/2/2021,4689456,252131,194236,57895,4437325,N,NULL,9,8/10/2020,NULL
238973,165472,5,7/3/2021,4492792,252131,196664,55467,4240661,N,NULL,9,8/10/2020,NULL
238974,165472,6,7/4/2021,4293670,252131,199122,53008,4041539,N,NULL,9,8/10/2020,NULL
238975,165472,7,7/5/2021,4092059,252131,201611,50519,3839928,N,NULL,9,8/10/2020,NULL
238976,165472,8,7/6/2021,3887928,252131,204131,47999,3635797,N,NULL,9,8/10/2020,NULL
238977,165472,9,7/7/2021,3681245,252131,206683,45447,3429114,N,NULL,9,8/10/2020,NULL
238978,165472,10,7/8/2021,3471978,252131,209267,42864,3219847,N,NULL,9,8/10/2020,NULL
238979,165472,11,7/9/2021,3260096,252131,211882,40248,3007965,N,NULL,9,8/10/2020,NULL
238980,165472,12,7/10/2021,3045565,252131,214531,37600,2793434,N,NULL,9,8/10/2020,NULL
238981,165472,13,7/11/2021,2828352,252131,217213,34918,2576221,N,NULL,9,8/10/2020,NULL
238982,165472,14,7/12/2021,2608424,252131,219928,32203,2356293,N,NULL,9,8/10/2020,NULL
238983,165472,15,7/1/2022,2385747,252131,222677,29454,2133616,N,NULL,9,8/10/2020,NULL
238984,165472,16,7/2/2022,2160287,252131,225460,26670,1908156,N,NULL,9,8/10/2020,NULL
238985,165472,17,7/3/2022,1932008,252131,228279,23852,1679877,N,NULL,9,8/10/2020,NULL
238986,165472,18,7/4/2022,1700876,252131,231132,20998,1448745,N,NULL,9,8/10/2020,NULL
238987,165472,19,7/5/2022,1466855,252131,234021,18109,1214724,N,NULL,9,8/10/2020,NULL
238988,165472,20,7/6/2022,1229908,252131,236947,15184,977777,N,NULL,9,8/10/2020,NULL
238989,165472,21,7/7/2022,990000,252131,239908,12222,737869,N,NULL,9,8/10/2020,NULL
238990,165472,22,7/8/2022,747093,252131,242907,9223,494962,N,NULL,9,8/10/2020,NULL
238991,165472,23,7/9/2022,501149,252131,245944,6187,249018,N,NULL,9,8/10/2020,NULL
238992,165472,24,7/10/2022,252131,252131,249018,3113,0,N,NULL,9,8/10/2020,NULL
238993,165473,1,7/11/2020,1518750,261051,242301,18750,1257699,Y,7/11/2020,9,8/10/2020,274426
238994,165473,2,23/11/2020,1273421,261051,245329,15721,1012370,C,23/11/2020,9,8/10/2020,NULL
238995,165473,3,23/11/2020,1025025,261051,248396,0,763974,C,23/11/2020,9,8/10/2020,NULL
238996,165473,4,23/11/2020,773524,261051,251501,0,512473,C,23/11/2020,9,8/10/2020,NULL
238997,165473,5,23/11/2020,518879,261051,254645,0,257828,C,23/11/2020,9,8/10/2020,NULL
238998,165473,6,23/11/2020,261051,261051,257828,0,0,C,23/11/2020,9,8/10/2020,NULL
238999,165474,1,8/11/2020,708750,92493,83743,8750,616257,Y,9/11/2020,9,12/10/2020,274449
239000,165474,2,8/12/2020,623960,92493,84790,7703,531467,Y,8/12/2020,9,12/10/2020,276004
239001,165474,3,8/1/2021,538110,92493,85850,6643,445617,N,NULL,9,12/10/2020,NULL
239002,165474,4,8/2/2021,451187,92493,86923,5570,358694,N,NULL,9,12/10/2020,NULL
239003,165474,5,8/3/2021,363177,92493,88010,4484,270684,N,NULL,9,12/10/2020,NULL
239004,165474,6,8/4/2021,274067,92493,89110,3384,181574,N,NULL,9,12/10/2020,NULL
239005,165474,7,8/5/2021,183843,92493,90224,2270,91350,N,NULL,9,12/10/2020,NULL
239006,165474,8,8/6/2021,92492,92493,91350,1142,0,N,NULL,9,12/10/2020,NULL
239007,165475,1,8/11/2020,6817637,1397613,1313445,84168,5420024,Y,9/11/2020,9,12/10/2020,274448
239008,165475,2,8/12/2020,5487774,1397613,1329863,67750,4090161,Y,8/12/2020,9,12/10/2020,276003
239009,165475,3,8/1/2021,4141288,1397613,1346486,51127,2743675,N,NULL,9,12/10/2020,NULL
239010,165475,4,8/2/2021,2777971,1397613,1363317,34296,1380358,N,NULL,9,12/10/2020,NULL
239011,165475,5,8/3/2021,1397612,1397613,1380358,17254,0,N,NULL,9,12/10/2020,NULL
239012,165476,1,15/11/2020,202500,68340,65840,2500,134160,Y,15/11/2020,9,16/10/2020,274634
239013,165476,2,15/12/2020,135837,68340,66663,1677,67497,Y,15/12/2020,9,16/10/2020,276294
239014,165476,3,15/01/2021,68340,68340,67497,844,0,N,NULL,9,16/10/2020,NULL
239015,165477,1,15/11/2020,40500000,951597,451597,500000,39548403,Y,15/11/2020,9,16/10/2020,274633
239016,165477,2,15/12/2020,40042758,951597,457242,494355,39091161,Y,15/12/2020,9,16/10/2020,276293
239017,165477,3,15/01/2021,39579800,951597,462958,488640,38628203,N,NULL,9,16/10/2020,NULL
239018,165477,4,15/02/2021,39111055,951597,468745,482853,38159458,N,NULL,9,16/10/2020,NULL
239019,165477,5,15/03/2021,38636451,951597,474604,476993,37684854,N,NULL,9,16/10/2020,NULL
239020,165477,6,15/04/2021,38155914,951597,480537,471061,37204317,N,NULL,9,16/10/2020,NULL
239021,165477,7,15/05/2021,37669371,951597,486543,465054,36717774,N,NULL,9,16/10/2020,NULL
239022,165477,8,15/06/2021,37176746,951597,492625,458972,36225149,N,NULL,9,16/10/2020,NULL
239023,165477,9,15/07/2021,36677963,951597,498783,452814,35726366,N,NULL,9,16/10/2020,NULL
239024,165477,10,15/08/2021,36172945,951597,505018,446580,35221348,N,NULL,9,16/10/2020,NULL
239025,165477,11,15/09/2021,35661615,951597,511330,440267,34710018,N,NULL,9,16/10/2020,NULL
239026,165477,12,15/10/2021,35143893,951597,517722,433875,34192296,N,NULL,9,16/10/2020,NULL
239027,165477,13,15/11/2021,34619700,951597,524193,427404,33668103,N,NULL,9,16/10/2020,NULL
239028,165477,14,15/12/2021,34088954,951597,530746,420851,33137357,N,NULL,9,16/10/2020,NULL
239029,165477,15,15/01/2022,33551574,951597,537380,414217,32599977,N,NULL,9,16/10/2020,NULL
239030,165477,16,15/02/2022,33007477,951597,544097,407500,32055880,N,NULL,9,16/10/2020,NULL
239031,165477,17,15/03/2022,32456578,951597,550899,400698,31504981,N,NULL,9,16/10/2020,NULL
239032,165477,18,15/04/2022,31898793,951597,557785,393812,30947196,N,NULL,9,16/10/2020,NULL
239033,165477,19,15/05/2022,31334036,951597,564757,386840,30382439,N,NULL,9,16/10/2020,NULL
239034,165477,20,15/06/2022,30762219,951597,571817,379780,29810622,N,NULL,9,16/10/2020,NULL
239035,165477,21,15/07/2022,30183255,951597,578964,372633,29231658,N,NULL,9,16/10/2020,NULL
239036,165477,22,15/08/2022,29597054,951597,586201,365396,28645457,N,NULL,9,16/10/2020,NULL
239037,165477,23,15/09/2022,29003525,951597,593529,358068,28051928,N,NULL,9,16/10/2020,NULL
239038,165477,24,15/10/2022,28402577,951597,600948,350649,27450980,N,NULL,9,16/10/2020,NULL
239039,165477,25,15/11/2022,27794117,951597,608460,343137,26842520,N,NULL,9,16/10/2020,NULL
239040,165477,26,15/12/2022,27178051,951597,616066,335531,26226454,N,NULL,9,16/10/2020,NULL
239041,165477,27,15/01/2023,26554284,951597,623767,327831,25602687,N,NULL,9,16/10/2020,NULL
239042,165477,28,15/02/2023,25922720,951597,631564,320034,24971123,N,NULL,9,16/10/2020,NULL
239043,165477,29,15/03/2023,25283262,951597,639458,312139,24331665,N,NULL,9,16/10/2020,NULL
239044,165477,30,15/04/2023,24635811,951597,647451,304146,23684214,N,NULL,9,16/10/2020,NULL
239045,165477,31,15/05/2023,23980266,951597,655545,296053,23028669,N,NULL,9,16/10/2020,NULL
239046,165477,32,15/06/2023,23316527,951597,663739,287858,22364930,N,NULL,9,16/10/2020,NULL
239047,165477,33,15/07/2023,22644491,951597,672036,279562,21692894,N,NULL,9,16/10/2020,NULL
239048,165477,34,15/08/2023,21964055,951597,680436,271161,21012458,N,NULL,9,16/10/2020,NULL
239049,165477,35,15/09/2023,21275114,951597,688941,262656,20323517,N,NULL,9,16/10/2020,NULL
239050,165477,36,15/10/2023,20577561,951597,697553,254044,19625964,N,NULL,9,16/10/2020,NULL
239051,165477,37,15/11/2023,19871288,951597,706273,245325,18919691,N,NULL,9,16/10/2020,NULL
239052,165477,38,15/12/2023,19156187,951597,715101,236496,18204590,N,NULL,9,16/10/2020,NULL
239053,165477,39,15/01/2024,18432147,951597,724040,227557,17480550,N,NULL,9,16/10/2020,NULL
239054,165477,40,15/02/2024,17699057,951597,733090,218507,16747460,N,NULL,9,16/10/2020,NULL
239055,165477,41,15/03/2024,16956803,951597,742254,209343,16005206,N,NULL,9,16/10/2020,NULL
239056,165477,42,15/04/2024,16205271,951597,751532,200065,15253674,N,NULL,9,16/10/2020,NULL
239057,165477,43,15/05/2024,15444345,951597,760926,190671,14492748,N,NULL,9,16/10/2020,NULL
239058,165477,44,15/06/2024,14673907,951597,770438,181159,13722310,N,NULL,9,16/10/2020,NULL
239059,165477,45,15/07/2024,13893839,951597,780068,171529,12942242,N,NULL,9,16/10/2020,NULL
239060,165477,46,15/08/2024,13104020,951597,789819,161778,12152423,N,NULL,9,16/10/2020,NULL
239061,165477,47,15/09/2024,12304328,951597,799692,151905,11352731,N,NULL,9,16/10/2020,NULL
239062,165477,48,15/10/2024,11494640,951597,809688,141909,10543043,N,NULL,9,16/10/2020,NULL
239063,165477,49,15/11/2024,10674831,951597,819809,131788,9723234,N,NULL,9,16/10/2020,NULL
239064,165477,50,15/12/2024,9844774,951597,830057,121540,8893177,N,NULL,9,16/10/2020,NULL
239065,165477,51,15/01/2025,9004342,951597,840432,111165,8052745,N,NULL,9,16/10/2020,NULL
239066,165477,52,15/02/2025,8153404,951597,850938,100659,7201807,N,NULL,9,16/10/2020,NULL
239067,165477,53,15/03/2025,7291829,951597,861575,90023,6340232,N,NULL,9,16/10/2020,NULL
239068,165477,54,15/04/2025,6419485,951597,872344,79253,5467888,N,NULL,9,16/10/2020,NULL
239069,165477,55,15/05/2025,5536236,951597,883249,68349,4584639,N,NULL,9,16/10/2020,NULL
239070,165477,56,15/06/2025,4641947,951597,894289,57308,3690350,N,NULL,9,16/10/2020,NULL
239071,165477,57,15/07/2025,3736479,951597,905468,46129,2784882,N,NULL,9,16/10/2020,NULL
239072,165477,58,15/08/2025,2819693,951597,916786,34811,1868096,N,NULL,9,16/10/2020,NULL
239073,165477,59,15/09/2025,1891447,951597,928246,23351,939850,N,NULL,9,16/10/2020,NULL
239074,165477,60,15/10/2025,951598,951597,939850,11748,0,N,NULL,9,16/10/2020,NULL
239075,165478,1,15/11/2020,10125000,237899,112899,125000,9887101,Y,15/11/2020,9,16/10/2020,274632
239076,165478,2,15/12/2020,10010689,237899,114311,123589,9772790,Y,15/12/2020,9,16/10/2020,276292
239077,165478,3,15/01/2021,9894950,237899,115739,122160,9657051,N,NULL,9,16/10/2020,NULL
239078,165478,4,15/02/2021,9777764,237899,117186,120713,9539865,N,NULL,9,16/10/2020,NULL
239079,165478,5,15/03/2021,9659113,237899,118651,119248,9421214,N,NULL,9,16/10/2020,NULL
239080,165478,6,15/04/2021,9538979,237899,120134,117765,9301080,N,NULL,9,16/10/2020,NULL
239081,165478,7,15/05/2021,9417343,237899,121636,116263,9179444,N,NULL,9,16/10/2020,NULL
239082,165478,8,15/06/2021,9294187,237899,123156,114743,9056288,N,NULL,9,16/10/2020,NULL
239083,165478,9,15/07/2021,9169491,237899,124696,113204,8931592,N,NULL,9,16/10/2020,NULL
239084,165478,10,15/08/2021,9043237,237899,126254,111645,8805338,N,NULL,9,16/10/2020,NULL
239085,165478,11,15/09/2021,8915404,237899,127833,110067,8677505,N,NULL,9,16/10/2020,NULL
239086,165478,12,15/10/2021,8785974,237899,129430,108469,8548075,N,NULL,9,16/10/2020,NULL
239087,165478,13,15/11/2021,8654926,237899,131048,106851,8417027,N,NULL,9,16/10/2020,NULL
239088,165478,14,15/12/2021,8522240,237899,132686,105213,8284341,N,NULL,9,16/10/2020,NULL
239089,165478,15,15/01/2022,8387895,237899,134345,103554,8149996,N,NULL,9,16/10/2020,NULL
239090,165478,16,15/02/2022,8251871,237899,136024,101875,8013972,N,NULL,9,16/10/2020,NULL
239091,165478,17,15/03/2022,8114146,237899,137725,100175,7876247,N,NULL,9,16/10/2020,NULL
239092,165478,18,15/04/2022,7974700,237899,139446,98453,7736801,N,NULL,9,16/10/2020,NULL
239093,165478,19,15/05/2022,7833511,237899,141189,96710,7595612,N,NULL,9,16/10/2020,NULL
239094,165478,20,15/06/2022,7690557,237899,142954,94945,7452658,N,NULL,9,16/10/2020,NULL
239095,165478,21,15/07/2022,7545816,237899,144741,93158,7307917,N,NULL,9,16/10/2020,NULL
239096,165478,22,15/08/2022,7399266,237899,146550,91349,7161367,N,NULL,9,16/10/2020,NULL
239097,165478,23,15/09/2022,7250884,237899,148382,89517,7012985,N,NULL,9,16/10/2020,NULL
239098,165478,24,15/10/2022,7100647,237899,150237,87662,6862748,N,NULL,9,16/10/2020,NULL
239099,165478,25,15/11/2022,6948532,237899,152115,85784,6710633,N,NULL,9,16/10/2020,NULL
239100,165478,26,15/12/2022,6794516,237899,154016,83883,6556617,N,NULL,9,16/10/2020,NULL
239101,165478,27,15/01/2023,6638574,237899,155942,81958,6400675,N,NULL,9,16/10/2020,NULL
239102,165478,28,15/02/2023,6480683,237899,157891,80008,6242784,N,NULL,9,16/10/2020,NULL
239103,165478,29,15/03/2023,6320818,237899,159865,78035,6082919,N,NULL,9,16/10/2020,NULL
239104,165478,30,15/04/2023,6158955,237899,161863,76036,5921056,N,NULL,9,16/10/2020,NULL
239105,165478,31,15/05/2023,5995069,237899,163886,74013,5757170,N,NULL,9,16/10/2020,NULL
239106,165478,32,15/06/2023,5829134,237899,165935,71965,5591235,N,NULL,9,16/10/2020,NULL
239107,165478,33,15/07/2023,5661125,237899,168009,69890,5423226,N,NULL,9,16/10/2020,NULL
239108,165478,34,15/08/2023,5491016,237899,170109,67790,5253117,N,NULL,9,16/10/2020,NULL
239109,165478,35,15/09/2023,5318781,237899,172235,65664,5080882,N,NULL,9,16/10/2020,NULL
239110,165478,36,15/10/2023,5144393,237899,174388,63511,4906494,N,NULL,9,16/10/2020,NULL
239111,165478,37,15/11/2023,4967825,237899,176568,61331,4729926,N,NULL,9,16/10/2020,NULL
239112,165478,38,15/12/2023,4789050,237899,178775,59124,4551151,N,NULL,9,16/10/2020,NULL
239113,165478,39,15/01/2024,4608040,237899,181010,56889,4370141,N,NULL,9,16/10/2020,NULL
239114,165478,40,15/02/2024,4424767,237899,183273,54627,4186868,N,NULL,9,16/10/2020,NULL
239115,165478,41,15/03/2024,4239204,237899,185563,52336,4001305,N,NULL,9,16/10/2020,NULL
239116,165478,42,15/04/2024,4051321,237899,187883,50016,3813422,N,NULL,9,16/10/2020,NULL
239117,165478,43,15/05/2024,3861089,237899,190232,47668,3623190,N,NULL,9,16/10/2020,NULL
239118,165478,44,15/06/2024,3668480,237899,192609,45290,3430581,N,NULL,9,16/10/2020,NULL
239119,165478,45,15/07/2024,3473463,237899,195017,42882,3235564,N,NULL,9,16/10/2020,NULL
239120,165478,46,15/08/2024,3276008,237899,197455,40445,3038109,N,NULL,9,16/10/2020,NULL
239121,165478,47,15/09/2024,3076085,237899,199923,37976,2838186,N,NULL,9,16/10/2020,NULL
239122,165478,48,15/10/2024,2873663,237899,202422,35477,2635764,N,NULL,9,16/10/2020,NULL
239123,165478,49,15/11/2024,2668711,237899,204952,32947,2430812,N,NULL,9,16/10/2020,NULL
239124,165478,50,15/12/2024,2461197,237899,207514,30385,2223298,N,NULL,9,16/10/2020,NULL
239125,165478,51,15/01/2025,2251089,237899,210108,27791,2013190,N,NULL,9,16/10/2020,NULL
239126,165478,52,15/02/2025,2038355,237899,212734,25165,1800456,N,NULL,9,16/10/2020,NULL
239127,165478,53,15/03/2025,1822961,237899,215394,22506,1585062,N,NULL,9,16/10/2020,NULL
239128,165478,54,15/04/2025,1604875,237899,218086,19813,1366976,N,NULL,9,16/10/2020,NULL
239129,165478,55,15/05/2025,1384063,237899,220812,17087,1146164,N,NULL,9,16/10/2020,NULL
239130,165478,56,15/06/2025,1160491,237899,223572,14327,922592,N,NULL,9,16/10/2020,NULL
239131,165478,57,15/07/2025,934124,237899,226367,11532,696225,N,NULL,9,16/10/2020,NULL
239132,165478,58,15/08/2025,704927,237899,229197,8703,467028,N,NULL,9,16/10/2020,NULL
239133,165478,59,15/09/2025,472865,237899,232062,5838,234966,N,NULL,9,16/10/2020,NULL
239134,165478,60,15/10/2025,237903,237899,234966,2937,0,N,NULL,9,16/10/2020,NULL
239135,165479,1,16/11/2020,2531250,225646,194396,31250,2305604,Y,16/11/2020,9,21/10/2020,274657
239136,165479,2,16/12/2020,2334424,225646,196826,28820,2108778,Y,16/12/2020,9,21/10/2020,276352
239137,165479,3,16/01/2021,2135138,225646,199286,26360,1909492,N,NULL,9,21/10/2020,NULL
239138,165479,4,16/02/2021,1933361,225646,201777,23869,1707715,N,NULL,9,21/10/2020,NULL
239139,165479,5,16/03/2021,1729062,225646,204299,21346,1503416,N,NULL,9,21/10/2020,NULL
239140,165479,6,16/04/2021,1522209,225646,206853,18793,1296563,N,NULL,9,21/10/2020,NULL
239141,165479,7,16/05/2021,1312770,225646,209439,16207,1087124,N,NULL,9,21/10/2020,NULL
239142,165479,8,16/06/2021,1100713,225646,212057,13589,875067,N,NULL,9,21/10/2020,NULL
239143,165479,9,16/07/2021,886006,225646,214707,10938,660360,N,NULL,9,21/10/2020,NULL
239144,165479,10,16/08/2021,668615,225646,217391,8254,442969,N,NULL,9,21/10/2020,NULL
239145,165479,11,16/09/2021,448506,225646,220109,5537,222860,N,NULL,9,21/10/2020,NULL
239146,165479,12,16/10/2021,225646,225646,222860,2786,0,N,NULL,9,21/10/2020,NULL
239147,165480,1,16/11/2020,1215000,309433,294433,15000,905567,Y,16/11/2020,9,21/10/2020,274656
239148,165480,2,16/12/2020,916886,309433,298114,11320,607453,N,NULL,9,21/10/2020,NULL
239149,165480,3,16/01/2021,615046,309433,301840,7593,305613,N,NULL,9,21/10/2020,NULL
239150,165480,4,16/02/2021,309433,309433,305613,3820,0,N,NULL,9,21/10/2020,NULL
239151,165481,1,16/11/2020,1014167,342822,328655,14167,671345,Y,16/11/2020,9,21/10/2020,274655
239152,165481,2,16/12/2020,680856,342822,333311,9511,338034,Y,16/12/2020,9,21/10/2020,276351
239153,165481,3,16/01/2021,342823,342822,338034,4789,0,N,NULL,9,21/10/2020,NULL
239154,165482,1,16/11/2020,2025000,348068,323068,25000,1676932,Y,16/11/2020,9,21/10/2020,274654
239155,165482,2,16/12/2020,1697894,348068,327106,20962,1349826,Y,16/12/2020,9,21/10/2020,276350
239156,165482,3,16/01/2021,1366699,348068,331195,16873,1018631,N,NULL,9,21/10/2020,NULL
239157,165482,4,16/02/2021,1031364,348068,335335,12733,683296,N,NULL,9,21/10/2020,NULL
239158,165482,5,16/03/2021,691838,348068,339526,8541,343770,N,NULL,9,21/10/2020,NULL
239159,165482,6,16/04/2021,348068,348068,343770,4297,0,N,NULL,9,21/10/2020,NULL
239160,165483,1,16/11/2020,1012500,1012500,1000000,12500,0,Y,16/11/2020,9,21/10/2020,274653
239161,165484,1,16/11/2020,1528222,515748,496881,18867,1012474,Y,16/11/2020,9,21/10/2020,274652
239162,165484,2,4/12/2020,1025130,515748,503092,12656,509382,C,4/12/2020,9,21/10/2020,NULL
239163,165484,3,4/12/2020,515749,515748,509382,0,0,C,4/12/2020,9,21/10/2020,NULL
239164,165485,1,20/11/2020,10125000,346653,221653,125000,9778347,Y,20/11/2020,9,21/10/2020,274925
239165,165485,2,20/12/2020,9900576,346653,224424,122229,9553923,Y,20/12/2020,9,21/10/2020,276578
239166,165485,3,20/01/2021,9673347,346653,227229,119424,9326694,N,NULL,9,21/10/2020,NULL
239167,165485,4,20/02/2021,9443277,346653,230070,116584,9096624,N,NULL,9,21/10/2020,NULL
239168,165485,5,20/03/2021,9210332,346653,232945,113708,8863679,N,NULL,9,21/10/2020,NULL
239169,165485,6,20/04/2021,8974475,346653,235857,110796,8627822,N,NULL,9,21/10/2020,NULL
239170,165485,7,20/05/2021,8735669,346653,238806,107848,8389016,N,NULL,9,21/10/2020,NULL
239171,165485,8,20/06/2021,8493878,346653,241791,104863,8147225,N,NULL,9,21/10/2020,NULL
239172,165485,9,20/07/2021,8249065,346653,244813,101840,7902412,N,NULL,9,21/10/2020,NULL
239173,165485,10,20/08/2021,8001192,346653,247873,98780,7654539,N,NULL,9,21/10/2020,NULL
239174,165485,11,20/09/2021,7750220,346653,250972,95682,7403567,N,NULL,9,21/10/2020,NULL
239175,165485,12,20/10/2021,7496111,346653,254109,92545,7149458,N,NULL,9,21/10/2020,NULL
239176,165485,13,20/11/2021,7238826,346653,257285,89368,6892173,N,NULL,9,21/10/2020,NULL
239177,165485,14,20/12/2021,6978325,346653,260501,86152,6631672,N,NULL,9,21/10/2020,NULL
239178,165485,15,20/01/2022,6714568,346653,263757,82896,6367915,N,NULL,9,21/10/2020,NULL
239179,165485,16,20/02/2022,6447514,346653,267054,79599,6100861,N,NULL,9,21/10/2020,NULL
239180,165485,17,20/03/2022,6177121,346653,270393,76261,5830468,N,NULL,9,21/10/2020,NULL
239181,165485,18,20/04/2022,5903349,346653,273772,72881,5556696,N,NULL,9,21/10/2020,NULL
239182,165485,19,20/05/2022,5626154,346653,277195,69459,5279501,N,NULL,9,21/10/2020,NULL
239183,165485,20,20/06/2022,5345494,346653,280660,65994,4998841,N,NULL,9,21/10/2020,NULL
239184,165485,21,20/07/2022,5061326,346653,284168,62486,4714673,N,NULL,9,21/10/2020,NULL
239185,165485,22,20/08/2022,4773606,346653,287720,58933,4426953,N,NULL,9,21/10/2020,NULL
239186,165485,23,20/09/2022,4482290,346653,291316,55337,4135637,N,NULL,9,21/10/2020,NULL
239187,165485,24,20/10/2022,4187332,346653,294958,51695,3840679,N,NULL,9,21/10/2020,NULL
239188,165485,25,20/11/2022,3888687,346653,298645,48008,3542034,N,NULL,9,21/10/2020,NULL
239189,165485,26,20/12/2022,3586309,346653,302378,44275,3239656,N,NULL,9,21/10/2020,NULL
239190,165485,27,20/01/2023,3280151,346653,306158,40496,2933498,N,NULL,9,21/10/2020,NULL
239191,165485,28,20/02/2023,2970166,346653,309985,36669,2623513,N,NULL,9,21/10/2020,NULL
239192,165485,29,20/03/2023,2656307,346653,313859,32794,2309654,N,NULL,9,21/10/2020,NULL
239193,165485,30,20/04/2023,2338524,346653,317783,28871,1991871,N,NULL,9,21/10/2020,NULL
239194,165485,31,20/05/2023,2016769,346653,321755,24898,1670116,N,NULL,9,21/10/2020,NULL
239195,165485,32,20/06/2023,1690992,346653,325777,20876,1344339,N,NULL,9,21/10/2020,NULL
239196,165485,33,20/07/2023,1361143,346653,329849,16804,1014490,N,NULL,9,21/10/2020,NULL
239197,165485,34,20/08/2023,1027171,346653,333972,12681,680518,N,NULL,9,21/10/2020,NULL
239198,165485,35,20/09/2023,689024,346653,338147,8507,342371,N,NULL,9,21/10/2020,NULL
239199,165485,36,20/10/2023,346650,346653,342371,4280,0,N,NULL,9,21/10/2020,NULL
239200,165486,1,20/11/2020,50625000,2424332,1799332,625000,48200668,Y,20/11/2020,9,21/10/2020,274924
239201,165486,2,10/12/2020,48803176,2424332,1821824,602508,46378844,C,10/12/2020,9,21/10/2020,NULL
239202,165486,3,10/12/2020,46958579,2424332,1844597,0,44534247,C,10/12/2020,9,21/10/2020,NULL
239203,165486,4,10/12/2020,45090925,2424332,1867654,0,42666593,C,10/12/2020,9,21/10/2020,NULL
239204,165486,5,10/12/2020,43199925,2424332,1891000,0,40775593,C,10/12/2020,9,21/10/2020,NULL
239205,165486,6,10/12/2020,41285288,2424332,1914637,0,38860956,C,10/12/2020,9,21/10/2020,NULL
239206,165486,7,10/12/2020,39346718,2424332,1938570,0,36922386,C,10/12/2020,9,21/10/2020,NULL
239207,165486,8,10/12/2020,37383915,2424332,1962803,0,34959583,C,10/12/2020,9,21/10/2020,NULL
239208,165486,9,10/12/2020,35396577,2424332,1987338,0,32972245,C,10/12/2020,9,21/10/2020,NULL
239209,165486,10,10/12/2020,33384398,2424332,2012179,0,30960066,C,10/12/2020,9,21/10/2020,NULL
239210,165486,11,10/12/2020,31347066,2424332,2037332,0,28922734,C,10/12/2020,9,21/10/2020,NULL
239211,165486,12,10/12/2020,29284268,2424332,2062798,0,26859936,C,10/12/2020,9,21/10/2020,NULL
239212,165486,13,10/12/2020,27195685,2424332,2088583,0,24771353,C,10/12/2020,9,21/10/2020,NULL
239213,165486,14,10/12/2020,25080994,2424332,2114691,0,22656662,C,10/12/2020,9,21/10/2020,NULL
239214,165486,15,10/12/2020,22939870,2424332,2141124,0,20515538,C,10/12/2020,9,21/10/2020,NULL
239215,165486,16,10/12/2020,20771982,2424332,2167888,0,18347650,C,10/12/2020,9,21/10/2020,NULL
239216,165486,17,10/12/2020,18576995,2424332,2194987,0,16152663,C,10/12/2020,9,21/10/2020,NULL
239217,165486,18,10/12/2020,16354571,2424332,2222424,0,13930239,C,10/12/2020,9,21/10/2020,NULL
239218,165486,19,10/12/2020,14104367,2424332,2250204,0,11680035,C,10/12/2020,9,21/10/2020,NULL
239219,165486,20,10/12/2020,11826035,2424332,2278332,0,9401703,C,10/12/2020,9,21/10/2020,NULL
239220,165486,21,10/12/2020,9519224,2424332,2306811,0,7094892,C,10/12/2020,9,21/10/2020,NULL
239221,165486,22,10/12/2020,7183578,2424332,2335646,0,4759246,C,10/12/2020,9,21/10/2020,NULL
239222,165486,23,10/12/2020,4818736,2424332,2364842,0,2394404,C,10/12/2020,9,21/10/2020,NULL
239223,165486,24,10/12/2020,2424334,2424332,2394404,0,0,C,10/12/2020,9,21/10/2020,NULL
239224,165487,1,20/11/2020,60750000,2909199,2159199,750000,57840801,Y,20/11/2020,9,21/10/2020,274923
239225,165487,2,20/12/2020,58563811,2909199,2186189,723010,55654612,Y,20/12/2020,9,21/10/2020,276577
239226,165487,3,20/01/2021,56350295,2909199,2213516,695683,53441096,N,NULL,9,21/10/2020,NULL
239227,165487,4,20/02/2021,54109110,2909199,2241185,668014,51199911,N,NULL,9,21/10/2020,NULL
239228,165487,5,20/03/2021,51839910,2909199,2269200,639999,48930711,N,NULL,9,21/10/2020,NULL
239229,165487,6,20/04/2021,49542345,2909199,2297565,611634,46633146,N,NULL,9,21/10/2020,NULL
239230,165487,7,20/05/2021,47216060,2909199,2326285,582914,44306861,N,NULL,9,21/10/2020,NULL
239231,165487,8,20/06/2021,44860697,2909199,2355363,553836,41951498,N,NULL,9,21/10/2020,NULL
239232,165487,9,20/07/2021,42475892,2909199,2384805,524394,39566693,N,NULL,9,21/10/2020,NULL
239233,165487,10,20/08/2021,40061277,2909199,2414615,494584,37152078,N,NULL,9,21/10/2020,NULL
239234,165487,11,20/09/2021,37616479,2909199,2444798,464401,34707280,N,NULL,9,21/10/2020,NULL
239235,165487,12,20/10/2021,35141121,2909199,2475358,433841,32231922,N,NULL,9,21/10/2020,NULL
239236,165487,13,20/11/2021,32634821,2909199,2506300,402899,29725622,N,NULL,9,21/10/2020,NULL
239237,165487,14,20/12/2021,30097192,2909199,2537629,371570,27187993,N,NULL,9,21/10/2020,NULL
239238,165487,15,20/01/2022,27527843,2909199,2569349,339850,24618644,N,NULL,9,21/10/2020,NULL
239239,165487,16,20/02/2022,24926377,2909199,2601466,307733,22017178,N,NULL,9,21/10/2020,NULL
239240,165487,17,20/03/2022,22292393,2909199,2633984,275215,19383194,N,NULL,9,21/10/2020,NULL
239241,165487,18,20/04/2022,19625484,2909199,2666909,242290,16716285,N,NULL,9,21/10/2020,NULL
239242,165487,19,20/05/2022,16925239,2909199,2700245,208954,14016040,N,NULL,9,21/10/2020,NULL
239243,165487,20,20/06/2022,14191241,2909199,2733998,175201,11282042,N,NULL,9,21/10/2020,NULL
239244,165487,21,20/07/2022,11423068,2909199,2768173,141026,8513869,N,NULL,9,21/10/2020,NULL
239245,165487,22,20/08/2022,8620292,2909199,2802776,106423,5711093,N,NULL,9,21/10/2020,NULL
239246,165487,23,20/09/2022,5782482,2909199,2837810,71389,2873283,N,NULL,9,21/10/2020,NULL
239247,165487,24,20/10/2022,2909199,2909199,2873283,35916,0,N,NULL,9,21/10/2020,NULL
239248,165488,1,20/11/2020,3240000,556908,516908,40000,2683092,Y,20/11/2020,9,21/10/2020,274922
239249,165488,2,20/12/2020,2716630,556908,523370,33539,2159722,Y,20/12/2020,9,21/10/2020,276576
239250,165488,3,20/01/2021,2186718,556908,529912,26997,1629810,N,NULL,9,21/10/2020,NULL
239251,165488,4,20/02/2021,1650182,556908,536536,20373,1093274,N,NULL,9,21/10/2020,NULL
239252,165488,5,20/03/2021,1106940,556908,543242,13666,550032,N,NULL,9,21/10/2020,NULL
239253,165488,6,20/04/2021,556907,556908,550032,6875,0,N,NULL,9,21/10/2020,NULL
239254,165489,1,20/11/2020,3042500,1028466,985966,42500,2014034,Y,20/11/2020,9,21/10/2020,274921
239255,165489,2,20/12/2020,2042566,1028466,999934,28532,1014100,Y,20/12/2020,9,21/10/2020,276575
239256,165489,3,20/01/2021,1028466,1028466,1014100,14366,0,N,NULL,9,21/10/2020,NULL
239257,165490,1,20/11/2020,8100000,1057065,957065,100000,7042935,Y,20/11/2020,9,21/10/2020,274920
239258,165490,2,27/11/2020,7130972,1057065,969028,88037,6073907,C,27/11/2020,9,21/10/2020,NULL
239259,165490,3,27/11/2020,6149831,1057065,981141,0,5092766,C,27/11/2020,9,21/10/2020,NULL
239260,165490,4,27/11/2020,5156425,1057065,993406,0,4099360,C,27/11/2020,9,21/10/2020,NULL
239261,165490,5,27/11/2020,4150602,1057065,1005823,0,3093537,C,27/11/2020,9,21/10/2020,NULL
239262,165490,6,27/11/2020,3132206,1057065,1018396,0,2075141,C,27/11/2020,9,21/10/2020,NULL
239263,165490,7,27/11/2020,2101080,1057065,1031126,0,1044015,C,27/11/2020,9,21/10/2020,NULL
239264,165490,8,27/11/2020,1057065,1057065,1044015,0,0,C,27/11/2020,9,21/10/2020,NULL
239265,165491,1,20/11/2020,4556250,218190,161940,56250,4338060,Y,20/11/2020,9,21/10/2020,274919
239266,165491,2,20/12/2020,4392286,218190,163964,54226,4174096,Y,20/12/2020,9,21/10/2020,276574
239267,165491,3,20/01/2021,4226272,218190,166014,52176,4008082,N,NULL,9,21/10/2020,NULL
239268,165491,4,20/02/2021,4058183,218190,168089,50101,3839993,N,NULL,9,21/10/2020,NULL
239269,165491,5,20/03/2021,3887993,218190,170190,48000,3669803,N,NULL,9,21/10/2020,NULL
239270,165491,6,20/04/2021,3715676,218190,172317,45873,3497486,N,NULL,9,21/10/2020,NULL
239271,165491,7,20/05/2021,3541205,218190,174471,43719,3323015,N,NULL,9,21/10/2020,NULL
239272,165491,8,20/06/2021,3364553,218190,176652,41538,3146363,N,NULL,9,21/10/2020,NULL
239273,165491,9,20/07/2021,3185693,218190,178860,39330,2967503,N,NULL,9,21/10/2020,NULL
239274,165491,10,20/08/2021,3004597,218190,181096,37094,2786407,N,NULL,9,21/10/2020,NULL
239275,165491,11,20/09/2021,2821237,218190,183360,34830,2603047,N,NULL,9,21/10/2020,NULL
239276,165491,12,20/10/2021,2635585,218190,185652,32538,2417395,N,NULL,9,21/10/2020,NULL
239277,165491,13,20/11/2021,2447613,218190,187972,30217,2229423,N,NULL,9,21/10/2020,NULL
239278,165491,14,20/12/2021,2257291,218190,190322,27868,2039101,N,NULL,9,21/10/2020,NULL
239279,165491,15,20/01/2022,2064590,218190,192701,25489,1846400,N,NULL,9,21/10/2020,NULL
239280,165491,16,20/02/2022,1869480,218190,195110,23080,1651290,N,NULL,9,21/10/2020,NULL
239281,165491,17,20/03/2022,1671931,218190,197549,20641,1453741,N,NULL,9,21/10/2020,NULL
239282,165491,18,20/04/2022,1471913,218190,200018,18172,1253723,N,NULL,9,21/10/2020,NULL
239283,165491,19,20/05/2022,1269395,218190,202518,15672,1051205,N,NULL,9,21/10/2020,NULL
239284,165491,20,20/06/2022,1064345,218190,205050,13140,846155,N,NULL,9,21/10/2020,NULL
239285,165491,21,20/07/2022,856732,218190,207613,10577,638542,N,NULL,9,21/10/2020,NULL
239286,165491,22,20/08/2022,646524,218190,210208,7982,428334,N,NULL,9,21/10/2020,NULL
239287,165491,23,20/09/2022,433688,218190,212836,5354,215498,N,NULL,9,21/10/2020,NULL
239288,165491,24,20/10/2022,218192,218190,215498,2694,0,N,NULL,9,21/10/2020,NULL
239289,165492,1,20/11/2020,10125000,2075621,1950621,125000,8049379,Y,20/11/2020,9,21/10/2020,274918
239290,165492,2,25/11/2020,8149996,2075621,1975004,100617,6074375,C,25/11/2020,9,21/10/2020,NULL
239291,165492,3,25/11/2020,6150305,2075621,1999691,0,4074684,C,25/11/2020,9,21/10/2020,NULL
239292,165492,4,25/11/2020,4125617,2075621,2024688,0,2049996,C,25/11/2020,9,21/10/2020,NULL
239293,165492,5,25/11/2020,2075621,2075621,2049996,0,0,C,25/11/2020,9,21/10/2020,NULL
239294,165493,1,20/11/2020,1014167,342822,328655,14167,671345,Y,20/11/2020,9,21/10/2020,274917
239295,165493,2,20/12/2020,680856,342822,333311,9511,338034,Y,20/12/2020,9,21/10/2020,276573
239296,165493,3,20/01/2021,342823,342822,338034,4789,0,N,NULL,9,21/10/2020,NULL
239297,165494,1,20/11/2020,3543750,609118,565368,43750,2934632,Y,20/11/2020,9,21/10/2020,274916
239298,165494,2,20/12/2020,2971315,609118,572435,36683,2362197,Y,20/12/2020,9,21/10/2020,276572
239299,165494,3,20/01/2021,2391724,609118,579591,29527,1782606,N,NULL,9,21/10/2020,NULL
239300,165494,4,20/02/2021,1804888,609118,586836,22283,1195770,N,NULL,9,21/10/2020,NULL
239301,165494,5,20/03/2021,1210717,609118,594171,14947,601599,N,NULL,9,21/10/2020,NULL
239302,165494,6,20/04/2021,609119,609118,601599,7520,0,N,NULL,9,21/10/2020,NULL
239303,165495,1,20/11/2020,1092041,368545,355063,13482,723496,Y,20/11/2020,9,21/10/2020,274915
239304,165495,2,18/12/2020,732540,368545,359501,9044,363995,C,18/12/2020,9,21/10/2020,276571
239305,165495,3,18/12/2020,368545,368545,363995,0,0,C,18/12/2020,9,21/10/2020,NULL
239306,165496,1,20/11/2020,5467610,487405,419903,67501,4980205,Y,20/11/2020,9,21/10/2020,274914
239307,165496,2,20/12/2020,5042458,487405,425152,62253,4555053,Y,20/12/2020,9,21/10/2020,276570
239308,165496,3,20/01/2021,4611992,487405,430466,56938,4124587,N,NULL,9,21/10/2020,NULL
239309,165496,4,20/02/2021,4176145,487405,435847,51557,3688740,N,NULL,9,21/10/2020,NULL
239310,165496,5,20/03/2021,3734850,487405,441295,46109,3247445,N,NULL,9,21/10/2020,NULL
239311,165496,6,20/04/2021,3288038,487405,446812,40593,2800633,N,NULL,9,21/10/2020,NULL
239312,165496,7,20/05/2021,2835641,487405,452397,35008,2348236,N,NULL,9,21/10/2020,NULL
239313,165496,8,20/06/2021,2377589,487405,458052,29353,1890184,N,NULL,9,21/10/2020,NULL
239314,165496,9,20/07/2021,1913812,487405,463777,23627,1426407,N,NULL,9,21/10/2020,NULL
239315,165496,10,20/08/2021,1444237,487405,469575,17830,956832,N,NULL,9,21/10/2020,NULL
239316,165496,11,20/09/2021,968793,487405,475444,11960,481388,N,NULL,9,21/10/2020,NULL
239317,165496,12,20/10/2021,487406,487405,481388,6017,0,N,NULL,9,21/10/2020,NULL
239318,165497,1,20/11/2020,10125000,484866,359866,125000,9640134,Y,20/11/2020,9,21/10/2020,274913
239319,165497,2,20/12/2020,9760635,484866,364365,120502,9275769,Y,20/12/2020,9,21/10/2020,276569
239320,165497,3,20/01/2021,9391716,484866,368919,115947,8906850,N,NULL,9,21/10/2020,NULL
239321,165497,4,20/02/2021,9018185,484866,373531,111336,8533319,N,NULL,9,21/10/2020,NULL
239322,165497,5,20/03/2021,8639985,484866,378200,106666,8155119,N,NULL,9,21/10/2020,NULL
239323,165497,6,20/04/2021,8257058,484866,382927,101939,7772192,N,NULL,9,21/10/2020,NULL
239324,165497,7,20/05/2021,7869344,484866,387714,97152,7384478,N,NULL,9,21/10/2020,NULL
239325,165497,8,20/06/2021,7476783,484866,392561,92306,6991917,N,NULL,9,21/10/2020,NULL
239326,165497,9,20/07/2021,7079315,484866,397468,87399,6594449,N,NULL,9,21/10/2020,NULL
239327,165497,10,20/08/2021,6676879,484866,402436,82431,6192013,N,NULL,9,21/10/2020,NULL
239328,165497,11,20/09/2021,6269413,484866,407466,77400,5784547,N,NULL,9,21/10/2020,NULL
239329,165497,12,20/10/2021,5856853,484866,412560,72307,5371987,N,NULL,9,21/10/2020,NULL
239330,165497,13,20/11/2021,5439136,484866,417717,67150,4954270,N,NULL,9,21/10/2020,NULL
239331,165497,14,20/12/2021,5016198,484866,422938,61928,4531332,N,NULL,9,21/10/2020,NULL
239332,165497,15,20/01/2022,4587973,484866,428225,56642,4103107,N,NULL,9,21/10/2020,NULL
239333,165497,16,20/02/2022,4154395,484866,433578,51289,3669529,N,NULL,9,21/10/2020,NULL
239334,165497,17,20/03/2022,3715398,484866,438997,45869,3230532,N,NULL,9,21/10/2020,NULL
239335,165497,18,20/04/2022,3270913,484866,444485,40382,2786047,N,NULL,9,21/10/2020,NULL
239336,165497,19,20/05/2022,2820872,484866,450041,34826,2336006,N,NULL,9,21/10/2020,NULL
239337,165497,20,20/06/2022,2365206,484866,455666,29200,1880340,N,NULL,9,21/10/2020,NULL
239338,165497,21,20/07/2022,1903844,484866,461362,23504,1418978,N,NULL,9,21/10/2020,NULL
239339,165497,22,20/08/2022,1436715,484866,467129,17737,951849,N,NULL,9,21/10/2020,NULL
239340,165497,23,20/09/2022,963747,484866,472968,11898,478881,N,NULL,9,21/10/2020,NULL
239341,165497,24,20/10/2022,484867,484866,478881,5986,0,N,NULL,9,21/10/2020,NULL
239342,165498,1,20/11/2020,50625000,1189497,564497,625000,49435503,Y,20/11/2020,9,21/10/2020,274912
239343,165498,2,20/12/2020,50053447,1189497,571553,617944,48863950,Y,20/12/2020,9,21/10/2020,276568
239344,165498,3,20/01/2021,49474750,1189497,578697,610799,48285253,N,NULL,9,21/10/2020,NULL
239345,165498,4,20/02/2021,48888819,1189497,585931,603566,47699322,N,NULL,9,21/10/2020,NULL
239346,165498,5,20/03/2021,48295564,1189497,593255,596242,47106067,N,NULL,9,21/10/2020,NULL
239347,165498,6,20/04/2021,47694893,1189497,600671,588826,46505396,N,NULL,9,21/10/2020,NULL
239348,165498,7,20/05/2021,47086714,1189497,608179,581317,45897217,N,NULL,9,21/10/2020,NULL
239349,165498,8,20/06/2021,46470933,1189497,615781,573715,45281436,N,NULL,9,21/10/2020,NULL
239350,165498,9,20/07/2021,45847454,1189497,623479,566018,44657957,N,NULL,9,21/10/2020,NULL
239351,165498,10,20/08/2021,45216182,1189497,631272,558224,44026685,N,NULL,9,21/10/2020,NULL
239352,165498,11,20/09/2021,44577019,1189497,639163,550334,43387522,N,NULL,9,21/10/2020,NULL
239353,165498,12,20/10/2021,43929867,1189497,647152,542344,42740370,N,NULL,9,21/10/2020,NULL
239354,165498,13,20/11/2021,43274625,1189497,655242,534255,42085128,N,NULL,9,21/10/2020,NULL
239355,165498,14,20/12/2021,42611193,1189497,663432,526064,41421696,N,NULL,9,21/10/2020,NULL
239356,165498,15,20/01/2022,41939468,1189497,671725,517771,40749971,N,NULL,9,21/10/2020,NULL
239357,165498,16,20/02/2022,41259346,1189497,680122,509375,40069849,N,NULL,9,21/10/2020,NULL
239358,165498,17,20/03/2022,40570723,1189497,688623,500873,39381226,N,NULL,9,21/10/2020,NULL
239359,165498,18,20/04/2022,39873492,1189497,697231,492265,38683995,N,NULL,9,21/10/2020,NULL
239360,165498,19,20/05/2022,39167545,1189497,705947,483550,37978048,N,NULL,9,21/10/2020,NULL
239361,165498,20,20/06/2022,38452774,1189497,714771,474726,37263277,N,NULL,9,21/10/2020,NULL
239362,165498,21,20/07/2022,37729068,1189497,723706,465791,36539571,N,NULL,9,21/10/2020,NULL
239363,165498,22,20/08/2022,36996316,1189497,732752,456745,35806819,N,NULL,9,21/10/2020,NULL
239364,165498,23,20/09/2022,36254405,1189497,741911,447585,35064908,N,NULL,9,21/10/2020,NULL
239365,165498,24,20/10/2022,35503220,1189497,751185,438311,34313723,N,NULL,9,21/10/2020,NULL
239366,165498,25,20/11/2022,34742645,1189497,760575,428922,33553148,N,NULL,9,21/10/2020,NULL
239367,165498,26,20/12/2022,33972563,1189497,770082,419414,32783066,N,NULL,9,21/10/2020,NULL
239368,165498,27,20/01/2023,33192855,1189497,779708,409788,32003358,N,NULL,9,21/10/2020,NULL
239369,165498,28,20/02/2023,32403400,1189497,789455,400042,31213903,N,NULL,9,21/10/2020,NULL
239370,165498,29,20/03/2023,31604077,1189497,799323,390174,30414580,N,NULL,9,21/10/2020,NULL
239371,165498,30,20/04/2023,30794763,1189497,809314,380182,29605266,N,NULL,9,21/10/2020,NULL
239372,165498,31,20/05/2023,29975332,1189497,819431,370066,28785835,N,NULL,9,21/10/2020,NULL
239373,165498,32,20/06/2023,29145658,1189497,829674,359823,27956161,N,NULL,9,21/10/2020,NULL
239374,165498,33,20/07/2023,28305614,1189497,840044,349452,27116117,N,NULL,9,21/10/2020,NULL
239375,165498,34,20/08/2023,27455069,1189497,850545,338951,26265572,N,NULL,9,21/10/2020,NULL
239376,165498,35,20/09/2023,26593892,1189497,861177,328320,25404395,N,NULL,9,21/10/2020,NULL
239377,165498,36,20/10/2023,25721950,1189497,871942,317555,24532453,N,NULL,9,21/10/2020,NULL
239378,165498,37,20/11/2023,24839109,1189497,882841,306656,23649612,N,NULL,9,21/10/2020,NULL
239379,165498,38,20/12/2023,23945233,1189497,893876,295620,22755736,N,NULL,9,21/10/2020,NULL
239380,165498,39,20/01/2024,23040183,1189497,905050,284447,21850686,N,NULL,9,21/10/2020,NULL
239381,165498,40,20/02/2024,22123820,1189497,916363,273134,20934323,N,NULL,9,21/10/2020,NULL
239382,165498,41,20/03/2024,21196003,1189497,927817,261679,20006506,N,NULL,9,21/10/2020,NULL
239383,165498,42,20/04/2024,20256588,1189497,939415,250081,19067091,N,NULL,9,21/10/2020,NULL
239384,165498,43,20/05/2024,19305430,1189497,951158,238339,18115933,N,NULL,9,21/10/2020,NULL
239385,165498,44,20/06/2024,18342383,1189497,963047,226449,17152886,N,NULL,9,21/10/2020,NULL
239386,165498,45,20/07/2024,17367298,1189497,975085,214411,16177801,N,NULL,9,21/10/2020,NULL
239387,165498,46,20/08/2024,16380024,1189497,987274,202223,15190527,N,NULL,9,21/10/2020,NULL
239388,165498,47,20/09/2024,15380409,1189497,999615,189882,14190912,N,NULL,9,21/10/2020,NULL
239389,165498,48,20/10/2024,14368299,1189497,1012110,177386,13178802,N,NULL,9,21/10/2020,NULL
239390,165498,49,20/11/2024,13343538,1189497,1024761,164735,12154041,N,NULL,9,21/10/2020,NULL
239391,165498,50,20/12/2024,12305967,1189497,1037571,151926,11116470,N,NULL,9,21/10/2020,NULL
239392,165498,51,20/01/2025,11255426,1189497,1050541,138956,10065929,N,NULL,9,21/10/2020,NULL
239393,165498,52,20/02/2025,10191754,1189497,1063672,125824,9002257,N,NULL,9,21/10/2020,NULL
239394,165498,53,20/03/2025,9114786,1189497,1076968,112528,7925289,N,NULL,9,21/10/2020,NULL
239395,165498,54,20/04/2025,8024356,1189497,1090430,99066,6834859,N,NULL,9,21/10/2020,NULL
239396,165498,55,20/05/2025,6920295,1189497,1104061,85436,5730798,N,NULL,9,21/10/2020,NULL
239397,165498,56,20/06/2025,5802433,1189497,1117862,71635,4612936,N,NULL,9,21/10/2020,NULL
239398,165498,57,20/07/2025,4670598,1189497,1131835,57662,3481101,N,NULL,9,21/10/2020,NULL
239399,165498,58,20/08/2025,3524615,1189497,1145983,43514,2335118,N,NULL,9,21/10/2020,NULL
239400,165498,59,20/09/2025,2364307,1189497,1160308,29189,1174810,N,NULL,9,21/10/2020,NULL
239401,165498,60,20/10/2025,1189496,1189497,1174810,14685,0,N,NULL,9,21/10/2020,NULL
239402,165499,1,20/11/2020,121500000,2854792,1354792,1500000,118645208,Y,20/11/2020,9,26/10/2020,274911
239403,165499,2,20/12/2020,120128273,2854792,1371727,1483065,117273481,Y,20/12/2020,9,26/10/2020,276567
239404,165499,3,20/01/2021,118739400,2854792,1388873,1465919,115884608,N,NULL,9,26/10/2020,NULL
239405,165499,4,20/02/2021,117333166,2854792,1406234,1448558,114478374,N,NULL,9,26/10/2020,NULL
239406,165499,5,20/03/2021,115909354,2854792,1423812,1430980,113054562,N,NULL,9,26/10/2020,NULL
239407,165499,6,20/04/2021,114467744,2854792,1441610,1413182,111612952,N,NULL,9,26/10/2020,NULL
239408,165499,7,20/05/2021,113008114,2854792,1459630,1395162,110153322,N,NULL,9,26/10/2020,NULL
239409,165499,8,20/06/2021,111530239,2854792,1477875,1376917,108675447,N,NULL,9,26/10/2020,NULL
239410,165499,9,20/07/2021,110033890,2854792,1496349,1358443,107179098,N,NULL,9,26/10/2020,NULL
239411,165499,10,20/08/2021,108518837,2854792,1515053,1339739,105664045,N,NULL,9,26/10/2020,NULL
239412,165499,11,20/09/2021,106984846,2854792,1533991,1320801,104130054,N,NULL,9,26/10/2020,NULL
239413,165499,12,20/10/2021,105431680,2854792,1553166,1301626,102576888,N,NULL,9,26/10/2020,NULL
239414,165499,13,20/11/2021,103859100,2854792,1572580,1282211,101004308,N,NULL,9,26/10/2020,NULL
239415,165499,14,20/12/2021,102266862,2854792,1592238,1262554,99412070,N,NULL,9,26/10/2020,NULL
239416,165499,15,20/01/2022,100654721,2854792,1612141,1242651,97799929,N,NULL,9,26/10/2020,NULL
239417,165499,16,20/02/2022,99022429,2854792,1632292,1222499,96167637,N,NULL,9,26/10/2020,NULL
239418,165499,17,20/03/2022,97369733,2854792,1652696,1202095,94514941,N,NULL,9,26/10/2020,NULL
239419,165499,18,20/04/2022,95696378,2854792,1673355,1181437,92841586,N,NULL,9,26/10/2020,NULL
239420,165499,19,20/05/2022,94002106,2854792,1694272,1160520,91147314,N,NULL,9,26/10/2020,NULL
239421,165499,20,20/06/2022,92286656,2854792,1715450,1139341,89431864,N,NULL,9,26/10/2020,NULL
239422,165499,21,20/07/2022,90549763,2854792,1736893,1117898,87694971,N,NULL,9,26/10/2020,NULL
239423,165499,22,20/08/2022,88791159,2854792,1758604,1096187,85936367,N,NULL,9,26/10/2020,NULL
239424,165499,23,20/09/2022,87010572,2854792,1780587,1074205,84155780,N,NULL,9,26/10/2020,NULL
239425,165499,24,20/10/2022,85207728,2854792,1802844,1051947,82352936,N,NULL,9,26/10/2020,NULL
239426,165499,25,20/11/2022,83382348,2854792,1825380,1029412,80527556,N,NULL,9,26/10/2020,NULL
239427,165499,26,20/12/2022,81534151,2854792,1848197,1006594,78679359,N,NULL,9,26/10/2020,NULL
239428,165499,27,20/01/2023,79662851,2854792,1871300,983492,76808059,N,NULL,9,26/10/2020,NULL
239429,165499,28,20/02/2023,77768160,2854792,1894691,960101,74913368,N,NULL,9,26/10/2020,NULL
239430,165499,29,20/03/2023,75849786,2854792,1918374,936417,72994994,N,NULL,9,26/10/2020,NULL
239431,165499,30,20/04/2023,73907432,2854792,1942354,912437,71052640,N,NULL,9,26/10/2020,NULL
239432,165499,31,20/05/2023,71940798,2854792,1966634,888158,69086006,N,NULL,9,26/10/2020,NULL
239433,165499,32,20/06/2023,69949581,2854792,1991217,863575,67094789,N,NULL,9,26/10/2020,NULL
239434,165499,33,20/07/2023,67933474,2854792,2016107,838685,65078682,N,NULL,9,26/10/2020,NULL
239435,165499,34,20/08/2023,65892166,2854792,2041308,813484,63037374,N,NULL,9,26/10/2020,NULL
239436,165499,35,20/09/2023,63825342,2854792,2066824,787967,60970550,N,NULL,9,26/10/2020,NULL
239437,165499,36,20/10/2023,61732682,2854792,2092660,762132,58877890,N,NULL,9,26/10/2020,NULL
239438,165499,37,20/11/2023,59613864,2854792,2118818,735974,56759072,N,NULL,9,26/10/2020,NULL
239439,165499,38,20/12/2023,57468561,2854792,2145303,709488,54613769,N,NULL,9,26/10/2020,NULL
239440,165499,39,20/01/2024,55296442,2854792,2172119,682672,52441650,N,NULL,9,26/10/2020,NULL
239441,165499,40,20/02/2024,53097171,2854792,2199271,655521,50242379,N,NULL,9,26/10/2020,NULL
239442,165499,41,20/03/2024,50870409,2854792,2226762,628030,48015617,N,NULL,9,26/10/2020,NULL
239443,165499,42,20/04/2024,48615813,2854792,2254596,600195,45761021,N,NULL,9,26/10/2020,NULL
239444,165499,43,20/05/2024,46333034,2854792,2282779,572013,43478242,N,NULL,9,26/10/2020,NULL
239445,165499,44,20/06/2024,44021720,2854792,2311314,543478,41166928,N,NULL,9,26/10/2020,NULL
239446,165499,45,20/07/2024,41681515,2854792,2340205,514587,38826723,N,NULL,9,26/10/2020,NULL
239447,165499,46,20/08/2024,39312057,2854792,2369458,485334,36457265,N,NULL,9,26/10/2020,NULL
239448,165499,47,20/09/2024,36912981,2854792,2399076,455716,34058189,N,NULL,9,26/10/2020,NULL
239449,165499,48,20/10/2024,34483917,2854792,2429064,425727,31629125,N,NULL,9,26/10/2020,NULL
239450,165499,49,20/11/2024,32024489,2854792,2459428,395364,29169697,N,NULL,9,26/10/2020,NULL
239451,165499,50,20/12/2024,29534319,2854792,2490170,364621,26679527,N,NULL,9,26/10/2020,NULL
239452,165499,51,20/01/2025,27013022,2854792,2521297,333494,24158230,N,NULL,9,26/10/2020,NULL
239453,165499,52,20/02/2025,24460208,2854792,2552814,301978,21605416,N,NULL,9,26/10/2020,NULL
239454,165499,53,20/03/2025,21875484,2854792,2584724,270068,19020692,N,NULL,9,26/10/2020,NULL
239455,165499,54,20/04/2025,19258451,2854792,2617033,237759,16403659,N,NULL,9,26/10/2020,NULL
239456,165499,55,20/05/2025,16608705,2854792,2649746,205046,13753913,N,NULL,9,26/10/2020,NULL
239457,165499,56,20/06/2025,13925837,2854792,2682868,171924,11071045,N,NULL,9,26/10/2020,NULL
239458,165499,57,20/07/2025,11209433,2854792,2716404,138388,8354641,N,NULL,9,26/10/2020,NULL
239459,165499,58,20/08/2025,8459074,2854792,2750359,104433,5604282,N,NULL,9,26/10/2020,NULL
239460,165499,59,20/09/2025,5674336,2854792,2784738,70054,2819544,N,NULL,9,26/10/2020,NULL
239461,165499,60,20/10/2025,2854789,2854792,2819544,35244,0,N,NULL,9,26/10/2020,NULL
239462,165500,1,29/10/2020,182550000,91916984,89366984,2550000,90633016,Y,7/12/2020,10,26/10/2020,275917
239463,165500,2,29/11/2020,91916984,91916984,90633016,1283968,0,Y,7/12/2020,10,26/10/2020,275918
239464,165501,1,21/11/2020,5062500,451292,388792,62500,4611208,Y,21/11/2020,9,26/10/2020,274943
239465,165501,2,9/12/2020,4668849,451292,393651,57640,4217557,C,9/12/2020,9,26/10/2020,NULL
239466,165501,3,9/12/2020,4270277,451292,398572,0,3818985,C,9/12/2020,9,26/10/2020,NULL
239467,165501,4,9/12/2020,3866723,451292,403554,0,3415431,C,9/12/2020,9,26/10/2020,NULL
239468,165501,5,9/12/2020,3458124,451292,408599,0,3006832,C,9/12/2020,9,26/10/2020,NULL
239469,165501,6,9/12/2020,3044418,451292,413706,0,2593126,C,9/12/2020,9,26/10/2020,NULL
239470,165501,7,9/12/2020,2625541,451292,418877,0,2174249,C,9/12/2020,9,26/10/2020,NULL
239471,165501,8,9/12/2020,2201428,451292,424113,0,1750136,C,9/12/2020,9,26/10/2020,NULL
239472,165501,9,9/12/2020,1772013,451292,429415,0,1320721,C,9/12/2020,9,26/10/2020,NULL
239473,165501,10,9/12/2020,1337230,451292,434783,0,885938,C,9/12/2020,9,26/10/2020,NULL
239474,165501,11,9/12/2020,897013,451292,440217,0,445721,C,9/12/2020,9,26/10/2020,NULL
239475,165501,12,9/12/2020,451293,451292,445721,0,0,C,9/12/2020,9,26/10/2020,NULL
239476,165502,1,21/11/2020,304250,102847,98597,4250,201403,Y,21/11/2020,9,27/10/2020,274942
239477,165502,2,24/11/2020,204257,102847,99993,2853,101410,Y,25/11/2020,9,27/10/2020,275189
239478,165502,3,24/11/2020,102847,102847,101410,0,0,Y,25/11/2020,9,27/10/2020,275190
239479,165503,1,23/11/2020,15642259,749077,555963,193114,14893182,Y,23/11/2020,9,28/10/2020,274970
239480,165503,2,23/11/2020,15079347,749077,562912,186165,14330270,C,23/11/2020,9,28/10/2020,NULL
239481,165503,3,23/11/2020,14509398,749077,569949,0,13760321,C,23/11/2020,9,28/10/2020,NULL
239482,165503,4,23/11/2020,13932325,749077,577073,0,13183248,C,23/11/2020,9,28/10/2020,NULL
239483,165503,5,23/11/2020,13348038,749077,584287,0,12598961,C,23/11/2020,9,28/10/2020,NULL
239484,165503,6,23/11/2020,12756448,749077,591590,0,12007371,C,23/11/2020,9,28/10/2020,NULL
239485,165503,7,23/11/2020,12157463,749077,598985,0,11408386,C,23/11/2020,9,28/10/2020,NULL
239486,165503,8,23/11/2020,11550991,749077,606472,0,10801914,C,23/11/2020,9,28/10/2020,NULL
239487,165503,9,23/11/2020,10936938,749077,614053,0,10187861,C,23/11/2020,9,28/10/2020,NULL
239488,165503,10,23/11/2020,10315209,749077,621729,0,9566132,C,23/11/2020,9,28/10/2020,NULL
239489,165503,11,23/11/2020,9685708,749077,629501,0,8936631,C,23/11/2020,9,28/10/2020,NULL
239490,165503,12,23/11/2020,9048339,749077,637369,0,8299262,C,23/11/2020,9,28/10/2020,NULL
239491,165503,13,23/11/2020,8403003,749077,645336,0,7653926,C,23/11/2020,9,28/10/2020,NULL
239492,165503,14,23/11/2020,7749600,749077,653403,0,7000523,C,23/11/2020,9,28/10/2020,NULL
239493,165503,15,23/11/2020,7088029,749077,661571,0,6338952,C,23/11/2020,9,28/10/2020,NULL
239494,165503,16,23/11/2020,6418189,749077,669840,0,5669112,C,23/11/2020,9,28/10/2020,NULL
239495,165503,17,23/11/2020,5739976,749077,678213,0,4990899,C,23/11/2020,9,28/10/2020,NULL
239496,165503,18,23/11/2020,5053285,749077,686691,0,4304208,C,23/11/2020,9,28/10/2020,NULL
239497,165503,19,23/11/2020,4358010,749077,695275,0,3608933,C,23/11/2020,9,28/10/2020,NULL
239498,165503,20,23/11/2020,3654044,749077,703966,0,2904967,C,23/11/2020,9,28/10/2020,NULL
239499,165503,21,23/11/2020,2941279,749077,712765,0,2192202,C,23/11/2020,9,28/10/2020,NULL
239500,165503,22,23/11/2020,2219604,749077,721675,0,1470527,C,23/11/2020,9,28/10/2020,NULL
239501,165503,23,23/11/2020,1488908,749077,730696,0,739831,C,23/11/2020,9,28/10/2020,NULL
239502,165503,24,23/11/2020,749079,749077,739831,0,0,C,23/11/2020,9,28/10/2020,NULL
239503,165504,1,23/11/2020,3036917,320948,283455,37493,2715969,Y,23/11/2020,9,28/10/2020,274969
239504,165504,2,23/12/2020,2749919,320948,286998,33950,2428971,N,NULL,9,28/10/2020,NULL
239505,165504,3,23/01/2021,2459334,320948,290585,30362,2138386,N,NULL,9,28/10/2020,NULL
239506,165504,4,23/02/2021,2165116,320948,294218,26730,1844168,N,NULL,9,28/10/2020,NULL
239507,165504,5,23/03/2021,1867221,320948,297895,23052,1546273,N,NULL,9,28/10/2020,NULL
239508,165504,6,23/04/2021,1565602,320948,301619,19328,1244654,N,NULL,9,28/10/2020,NULL
239509,165504,7,23/05/2021,1260213,320948,305389,15558,939265,N,NULL,9,28/10/2020,NULL
239510,165504,8,23/06/2021,951006,320948,309207,11741,630058,N,NULL,9,28/10/2020,NULL
239511,165504,9,23/07/2021,637934,320948,313072,7876,316986,N,NULL,9,28/10/2020,NULL
239512,165504,10,23/08/2021,320949,320948,316986,3962,0,N,NULL,9,28/10/2020,NULL
239513,165505,1,23/11/2020,5392581,480716,414141,66575,4911865,Y,23/11/2020,9,28/10/2020,274968
239514,165505,2,23/12/2020,4973263,480716,419318,61398,4492547,N,NULL,9,28/10/2020,NULL
239515,165505,3,23/01/2021,4548704,480716,424559,56157,4067988,N,NULL,9,28/10/2020,NULL
239516,165505,4,23/02/2021,4118838,480716,429866,50850,3638122,N,NULL,9,28/10/2020,NULL
239517,165505,5,23/03/2021,3683598,480716,435240,45477,3202882,N,NULL,9,28/10/2020,NULL
239518,165505,6,23/04/2021,3242918,480716,440680,40036,2762202,N,NULL,9,28/10/2020,NULL
239519,165505,7,23/05/2021,2796729,480716,446189,34528,2316013,N,NULL,9,28/10/2020,NULL
239520,165505,8,23/06/2021,2344963,480716,451766,28950,1864247,N,NULL,9,28/10/2020,NULL
239521,165505,9,23/07/2021,1887550,480716,457413,23303,1406834,N,NULL,9,28/10/2020,NULL
239522,165505,10,23/08/2021,1424419,480716,463131,17585,943703,N,NULL,9,28/10/2020,NULL
239523,165505,11,23/09/2021,955499,480716,468920,11796,474783,N,NULL,9,28/10/2020,NULL
239524,165505,12,23/10/2021,480717,480716,474783,5935,0,N,NULL,9,28/10/2020,NULL
239525,165506,1,23/11/2020,18731250,440114,208864,231250,18291136,Y,23/11/2020,9,28/10/2020,274967
239526,165506,2,23/12/2020,18519775,440114,211475,228639,18079661,N,NULL,9,28/10/2020,NULL
239527,165506,3,23/01/2021,18305657,440114,214118,225996,17865543,N,NULL,9,28/10/2020,NULL
239528,165506,4,23/02/2021,18088863,440114,216794,223319,17648749,N,NULL,9,28/10/2020,NULL
239529,165506,5,23/03/2021,17869359,440114,219504,220609,17429245,N,NULL,9,28/10/2020,NULL
239530,165506,6,23/04/2021,17647111,440114,222248,217866,17206997,N,NULL,9,28/10/2020,NULL
239531,165506,7,23/05/2021,17422085,440114,225026,215087,16981971,N,NULL,9,28/10/2020,NULL
239532,165506,8,23/06/2021,17194246,440114,227839,212275,16754132,N,NULL,9,28/10/2020,NULL
239533,165506,9,23/07/2021,16963559,440114,230687,209427,16523445,N,NULL,9,28/10/2020,NULL
239534,165506,10,23/08/2021,16729988,440114,233571,206543,16289874,N,NULL,9,28/10/2020,NULL
239535,165506,11,23/09/2021,16493498,440114,236490,203623,16053384,N,NULL,9,28/10/2020,NULL
239536,165506,12,23/10/2021,16254052,440114,239446,200667,15813938,N,NULL,9,28/10/2020,NULL
239537,165506,13,23/11/2021,16011613,440114,242439,197674,15571499,N,NULL,9,28/10/2020,NULL
239538,165506,14,23/12/2021,15766143,440114,245470,194644,15326029,N,NULL,9,28/10/2020,NULL
239539,165506,15,23/01/2022,15517605,440114,248538,191575,15077491,N,NULL,9,28/10/2020,NULL
239540,165506,16,23/02/2022,15265960,440114,251645,188469,14825846,N,NULL,9,28/10/2020,NULL
239541,165506,17,23/03/2022,15011169,440114,254791,185323,14571055,N,NULL,9,28/10/2020,NULL
239542,165506,18,23/04/2022,14753193,440114,257976,182138,14313079,N,NULL,9,28/10/2020,NULL
239543,165506,19,23/05/2022,14491993,440114,261200,178913,14051879,N,NULL,9,28/10/2020,NULL
239544,165506,20,23/06/2022,14227528,440114,264465,175648,13787414,N,NULL,9,28/10/2020,NULL
239545,165506,21,23/07/2022,13959757,440114,267771,172343,13519643,N,NULL,9,28/10/2020,NULL
239546,165506,22,23/08/2022,13688639,440114,271118,168996,13248525,N,NULL,9,28/10/2020,NULL
239547,165506,23,23/09/2022,13414132,440114,274507,165607,12974018,N,NULL,9,28/10/2020,NULL
239548,165506,24,23/10/2022,13136193,440114,277939,162175,12696079,N,NULL,9,28/10/2020,NULL
239549,165506,25,23/11/2022,12854780,440114,281413,158701,12414666,N,NULL,9,28/10/2020,NULL
239550,165506,26,23/12/2022,12569850,440114,284930,155183,12129736,N,NULL,9,28/10/2020,NULL
239551,165506,27,23/01/2023,12281358,440114,288492,151622,11841244,N,NULL,9,28/10/2020,NULL
239552,165506,28,23/02/2023,11989260,440114,292098,148016,11549146,N,NULL,9,28/10/2020,NULL
239553,165506,29,23/03/2023,11693511,440114,295749,144364,11253397,N,NULL,9,28/10/2020,NULL
239554,165506,30,23/04/2023,11394065,440114,299446,140667,10953951,N,NULL,9,28/10/2020,NULL
239555,165506,31,23/05/2023,11090876,440114,303189,136924,10650762,N,NULL,9,28/10/2020,NULL
239556,165506,32,23/06/2023,10783897,440114,306979,133134,10343783,N,NULL,9,28/10/2020,NULL
239557,165506,33,23/07/2023,10473081,440114,310816,129297,10032967,N,NULL,9,28/10/2020,NULL
239558,165506,34,23/08/2023,10158379,440114,314702,125412,9718265,N,NULL,9,28/10/2020,NULL
239559,165506,35,23/09/2023,9839744,440114,318635,121478,9399630,N,NULL,9,28/10/2020,NULL
239560,165506,36,23/10/2023,9517126,440114,322618,117495,9077012,N,NULL,9,28/10/2020,NULL
239561,165506,37,23/11/2023,9190475,440114,326651,113463,8750361,N,NULL,9,28/10/2020,NULL
239562,165506,38,23/12/2023,8859741,440114,330734,109379,8419627,N,NULL,9,28/10/2020,NULL
239563,165506,39,23/01/2024,8524873,440114,334868,105245,8084759,N,NULL,9,28/10/2020,NULL
239564,165506,40,23/02/2024,8185819,440114,339054,101059,7745705,N,NULL,9,28/10/2020,NULL
239565,165506,41,23/03/2024,7842527,440114,343292,96821,7402413,N,NULL,9,28/10/2020,NULL
239566,165506,42,23/04/2024,7494943,440114,347584,92530,7054829,N,NULL,9,28/10/2020,NULL
239567,165506,43,23/05/2024,7143015,440114,351928,88185,6702901,N,NULL,9,28/10/2020,NULL
239568,165506,44,23/06/2024,6786687,440114,356328,83786,6346573,N,NULL,9,28/10/2020,NULL
239569,165506,45,23/07/2024,6425905,440114,360782,79332,5985791,N,NULL,9,28/10/2020,NULL
239570,165506,46,23/08/2024,6060614,440114,365291,74822,5620500,N,NULL,9,28/10/2020,NULL
239571,165506,47,23/09/2024,5690756,440114,369858,70256,5250642,N,NULL,9,28/10/2020,NULL
239572,165506,48,23/10/2024,5316275,440114,374481,65633,4876161,N,NULL,9,28/10/2020,NULL
239573,165506,49,23/11/2024,4937113,440114,379162,60952,4496999,N,NULL,9,28/10/2020,NULL
239574,165506,50,23/12/2024,4553212,440114,383901,56212,4113098,N,NULL,9,28/10/2020,NULL
239575,165506,51,23/01/2025,4164512,440114,388700,51414,3724398,N,NULL,9,28/10/2020,NULL
239576,165506,52,23/02/2025,3770953,440114,393559,46555,3330839,N,NULL,9,28/10/2020,NULL
239577,165506,53,23/03/2025,3372475,440114,398478,41635,2932361,N,NULL,9,28/10/2020,NULL
239578,165506,54,23/04/2025,2969016,440114,403459,36654,2528902,N,NULL,9,28/10/2020,NULL
239579,165506,55,23/05/2025,2560514,440114,408502,31611,2120400,N,NULL,9,28/10/2020,NULL
239580,165506,56,23/06/2025,2146905,440114,413609,26505,1706791,N,NULL,9,28/10/2020,NULL
239581,165506,57,23/07/2025,1728126,440114,418779,21335,1288012,N,NULL,9,28/10/2020,NULL
239582,165506,58,23/08/2025,1304112,440114,424014,16100,863998,N,NULL,9,28/10/2020,NULL
239583,165506,59,23/09/2025,874798,440114,429314,10800,434684,N,NULL,9,28/10/2020,NULL
239584,165506,60,23/10/2025,440118,440114,434684,5434,0,N,NULL,9,28/10/2020,NULL
239585,165507,1,23/11/2020,1014167,342822,328655,14167,671345,Y,23/11/2020,9,28/10/2020,274966
239586,165507,2,23/12/2020,680856,342822,333311,9511,338034,N,NULL,9,28/10/2020,NULL
239587,165507,3,23/01/2021,342823,342822,338034,4789,0,N,NULL,9,28/10/2020,NULL
239588,165508,1,23/11/2020,9941251,273257,150525,122731,9667994,Y,23/11/2020,9,28/10/2020,274965
239589,165508,2,23/12/2020,9788844,273257,152407,120850,9515587,N,NULL,9,28/10/2020,NULL
239590,165508,3,23/01/2021,9634532,273257,154312,118945,9361275,N,NULL,9,28/10/2020,NULL
239591,165508,4,23/02/2021,9478291,273257,156241,117016,9205034,N,NULL,9,28/10/2020,NULL
239592,165508,5,23/03/2021,9320097,273257,158194,115063,9046840,N,NULL,9,28/10/2020,NULL
239593,165508,6,23/04/2021,9159926,273257,160171,113086,8886669,N,NULL,9,28/10/2020,NULL
239594,165508,7,23/05/2021,8997753,273257,162173,111083,8724496,N,NULL,9,28/10/2020,NULL
239595,165508,8,23/06/2021,8833552,273257,164201,109056,8560295,N,NULL,9,28/10/2020,NULL
239596,165508,9,23/07/2021,8667299,273257,166253,107004,8394042,N,NULL,9,28/10/2020,NULL
239597,165508,10,23/08/2021,8498968,273257,168331,104926,8225711,N,NULL,9,28/10/2020,NULL
239598,165508,11,23/09/2021,8328533,273257,170435,102821,8055276,N,NULL,9,28/10/2020,NULL
239599,165508,12,23/10/2021,8155967,273257,172566,100691,7882710,N,NULL,9,28/10/2020,NULL
239600,165508,13,23/11/2021,7981244,273257,174723,98534,7707987,N,NULL,9,28/10/2020,NULL
239601,165508,14,23/12/2021,7804337,273257,176907,96350,7531080,N,NULL,9,28/10/2020,NULL
239602,165508,15,23/01/2022,7625219,273257,179118,94139,7351962,N,NULL,9,28/10/2020,NULL
239603,165508,16,23/02/2022,7443862,273257,181357,91900,7170605,N,NULL,9,28/10/2020,NULL
239604,165508,17,23/03/2022,7260238,273257,183624,89633,6986981,N,NULL,9,28/10/2020,NULL
239605,165508,18,23/04/2022,7074319,273257,185919,87337,6801062,N,NULL,9,28/10/2020,NULL
239606,165508,19,23/05/2022,6886076,273257,188243,85013,6612819,N,NULL,9,28/10/2020,NULL
239607,165508,20,23/06/2022,6695479,273257,190597,82660,6422222,N,NULL,9,28/10/2020,NULL
239608,165508,21,23/07/2022,6502500,273257,192979,80278,6229243,N,NULL,9,28/10/2020,NULL
239609,165508,22,23/08/2022,6307109,273257,195391,77866,6033852,N,NULL,9,28/10/2020,NULL
239610,165508,23,23/09/2022,6109275,273257,197834,75423,5836018,N,NULL,9,28/10/2020,NULL
239611,165508,24,23/10/2022,5908968,273257,200307,72950,5635711,N,NULL,9,28/10/2020,NULL
239612,165508,25,23/11/2022,5706158,273257,202810,70446,5432901,N,NULL,9,28/10/2020,NULL
239613,165508,26,23/12/2022,5500813,273257,205345,67911,5227556,N,NULL,9,28/10/2020,NULL
239614,165508,27,23/01/2023,5292901,273257,207912,65344,5019644,N,NULL,9,28/10/2020,NULL
239615,165508,28,23/02/2023,5082390,273257,210511,62746,4809133,N,NULL,9,28/10/2020,NULL
239616,165508,29,23/03/2023,4869247,273257,213143,60114,4595990,N,NULL,9,28/10/2020,NULL
239617,165508,30,23/04/2023,4653440,273257,215807,57450,4380183,N,NULL,9,28/10/2020,NULL
239618,165508,31,23/05/2023,4434936,273257,218504,54752,4161679,N,NULL,9,28/10/2020,NULL
239619,165508,32,23/06/2023,4213700,273257,221236,52021,3940443,N,NULL,9,28/10/2020,NULL
239620,165508,33,23/07/2023,3989699,273257,224001,49256,3716442,N,NULL,9,28/10/2020,NULL
239621,165508,34,23/08/2023,3762898,273257,226801,46456,3489641,N,NULL,9,28/10/2020,NULL
239622,165508,35,23/09/2023,3533262,273257,229636,43620,3260005,N,NULL,9,28/10/2020,NULL
239623,165508,36,23/10/2023,3300755,273257,232507,40750,3027498,N,NULL,9,28/10/2020,NULL
239624,165508,37,23/11/2023,3065342,273257,235413,37844,2792085,N,NULL,9,28/10/2020,NULL
239625,165508,38,23/12/2023,2826986,273257,238356,34901,2553729,N,NULL,9,28/10/2020,NULL
239626,165508,39,23/01/2024,2585651,273257,241335,31922,2312394,N,NULL,9,28/10/2020,NULL
239627,165508,40,23/02/2024,2341299,273257,244352,28905,2068042,N,NULL,9,28/10/2020,NULL
239628,165508,41,23/03/2024,2093893,273257,247406,25851,1820636,N,NULL,9,28/10/2020,NULL
239629,165508,42,23/04/2024,1843394,273257,250499,22758,1570137,N,NULL,9,28/10/2020,NULL
239630,165508,43,23/05/2024,1589764,273257,253630,19627,1316507,N,NULL,9,28/10/2020,NULL
239631,165508,44,23/06/2024,1332964,273257,256800,16456,1059707,N,NULL,9,28/10/2020,NULL
239632,165508,45,23/07/2024,1072954,273257,260010,13246,799697,N,NULL,9,28/10/2020,NULL
239633,165508,46,23/08/2024,809693,273257,263261,9996,536436,N,NULL,9,28/10/2020,NULL
239634,165508,47,23/09/2024,543142,273257,266551,6705,269885,N,NULL,9,28/10/2020,NULL
239635,165508,48,23/10/2024,273259,273257,269885,3374,0,N,NULL,9,28/10/2020,NULL
239636,165509,1,26/11/2020,405667,137129,131462,5667,268538,Y,26/11/2020,9,28/10/2020,275216
239637,165509,2,26/12/2020,272342,137129,133325,3804,135213,N,NULL,9,28/10/2020,NULL
239638,165509,3,26/01/2021,137129,137129,135213,1916,0,N,NULL,9,28/10/2020,NULL
239639,165510,1,26/11/2020,9002747,802541,691396,111145,8200206,Y,26/11/2020,9,28/10/2020,275215
239640,165510,2,26/12/2020,8302709,802541,700038,102503,7500168,N,NULL,9,28/10/2020,NULL
239641,165510,3,26/01/2021,7593920,802541,708789,93752,6791379,N,NULL,9,28/10/2020,NULL
239642,165510,4,26/02/2021,6876271,802541,717649,84892,6073730,N,NULL,9,28/10/2020,NULL
239643,165510,5,26/03/2021,6149652,802541,726619,75922,5347111,N,NULL,9,28/10/2020,NULL
239644,165510,6,26/04/2021,5413950,802541,735702,66839,4611409,N,NULL,9,28/10/2020,NULL
239645,165510,7,26/05/2021,4669052,802541,744898,57643,3866511,N,NULL,9,28/10/2020,NULL
239646,165510,8,26/06/2021,3914842,802541,754210,48331,3112301,N,NULL,9,28/10/2020,NULL
239647,165510,9,26/07/2021,3151205,802541,763637,38904,2348664,N,NULL,9,28/10/2020,NULL
239648,165510,10,26/08/2021,2378022,802541,773183,29358,1575481,N,NULL,9,28/10/2020,NULL
239649,165510,11,26/09/2021,1595175,802541,782847,19694,792634,N,NULL,9,28/10/2020,NULL
239650,165510,12,26/10/2021,802542,802541,792634,9908,0,N,NULL,9,28/10/2020,NULL
239651,165511,1,27/11/2020,3846692,342910,295420,47490,3503782,Y,27/11/2020,9,28/10/2020,275300
239652,165511,2,27/12/2020,3547580,342910,299112,43797,3204670,N,NULL,9,28/10/2020,NULL
239653,165511,3,27/01/2021,3244729,342910,302851,40058,2901819,N,NULL,9,28/10/2020,NULL
239654,165511,4,27/02/2021,2938092,342910,306637,36273,2595182,N,NULL,9,28/10/2020,NULL
239655,165511,5,27/03/2021,2627622,342910,310470,32440,2284712,N,NULL,9,28/10/2020,NULL
239656,165511,6,27/04/2021,2313271,342910,314351,28559,1970361,N,NULL,9,28/10/2020,NULL
239657,165511,7,27/05/2021,1994991,342910,318280,24630,1652081,N,NULL,9,28/10/2020,NULL
239658,165511,8,27/06/2021,1672732,342910,322259,20651,1329822,N,NULL,9,28/10/2020,NULL
239659,165511,9,27/07/2021,1346445,342910,326287,16623,1003535,N,NULL,9,28/10/2020,NULL
239660,165511,10,27/08/2021,1016080,342910,330365,12544,673170,N,NULL,9,28/10/2020,NULL
239661,165511,11,27/09/2021,681585,342910,334495,8415,338675,N,NULL,9,28/10/2020,NULL
239662,165511,12,27/10/2021,342909,342910,338675,4233,0,N,NULL,9,28/10/2020,NULL
239663,165512,1,27/11/2020,506250,254697,248447,6250,251553,Y,27/11/2020,9,28/10/2020,275305
239664,165512,2,27/11/2020,254697,254697,251553,0,0,Y,27/11/2020,9,28/10/2020,275306
239665,165513,1,2/12/2020,2028333,685644,657311,28333,1342689,Y,2/12/2020,10,2/11/2020,275541
239666,165513,2,2/1/2021,1361710,685644,666623,19021,676066,N,NULL,10,2/11/2020,NULL
239667,165513,3,2/2/2021,685643,685644,676066,9578,0,N,NULL,10,2/11/2020,NULL
239668,165514,1,2/12/2020,1771919,304567,282691,21876,1467352,Y,2/12/2020,10,2/11/2020,275540
239669,165514,2,2/1/2021,1485694,304567,286225,18342,1181127,N,NULL,10,2/11/2020,NULL
239670,165514,3,2/2/2021,1195891,304567,289803,14764,891324,N,NULL,10,2/11/2020,NULL
239671,165514,4,2/3/2021,902466,304567,293425,11142,597899,N,NULL,10,2/11/2020,NULL
239672,165514,5,2/4/2021,605373,304567,297093,7474,300806,N,NULL,10,2/11/2020,NULL
239673,165514,6,2/5/2021,304566,304567,300806,3760,0,N,NULL,10,2/11/2020,NULL
239674,165515,1,2/12/2020,10125000,1070031,945031,125000,9054969,Y,2/12/2020,10,2/11/2020,275539
239675,165515,2,2/1/2021,9168156,1070031,956844,113187,8098125,N,NULL,10,2/11/2020,NULL
239676,165515,3,2/2/2021,8199352,1070031,968804,101227,7129321,N,NULL,10,2/11/2020,NULL
239677,165515,4,2/3/2021,7218438,1070031,980914,89117,6148407,N,NULL,10,2/11/2020,NULL
239678,165515,5,2/4/2021,6225262,1070031,993176,76855,5155231,N,NULL,10,2/11/2020,NULL
239679,165515,6,2/5/2021,5219672,1070031,1005590,64440,4149641,N,NULL,10,2/11/2020,NULL
239680,165515,7,2/6/2021,4201512,1070031,1018160,51871,3131481,N,NULL,10,2/11/2020,NULL
239681,165515,8,2/7/2021,3170625,1070031,1030887,39144,2100594,N,NULL,10,2/11/2020,NULL
239682,165515,9,2/8/2021,2126852,1070031,1043773,26257,1056821,N,NULL,10,2/11/2020,NULL
239683,165515,10,2/9/2021,1070032,1070031,1056821,13210,0,N,NULL,10,2/11/2020,NULL
239684,165516,1,30/11/2020,10115482,237676,112793,124882,9877806,Y,30/11/2020,9,3/11/2020,275377
239685,165516,2,30/12/2020,10001279,237676,114203,123473,9763603,N,NULL,9,3/11/2020,NULL
239686,165516,3,30/01/2021,9885648,237676,115631,122045,9647972,N,NULL,9,3/11/2020,NULL
239687,165516,4,28/02/2021,9768572,237676,117076,120600,9530896,N,NULL,9,3/11/2020,NULL
239688,165516,5,28/03/2021,9650033,237676,118539,119136,9412357,N,NULL,9,3/11/2020,NULL
239689,165516,6,28/04/2021,9530012,237676,120021,117654,9292336,N,NULL,9,3/11/2020,NULL
239690,165516,7,28/05/2021,9408491,237676,121521,116154,9170815,N,NULL,9,3/11/2020,NULL
239691,165516,8,28/06/2021,9285451,237676,123040,114635,9047775,N,NULL,9,3/11/2020,NULL
239692,165516,9,28/07/2021,9160873,237676,124578,113097,8923197,N,NULL,9,3/11/2020,NULL
239693,165516,10,28/08/2021,9034737,237676,126136,111540,8797061,N,NULL,9,3/11/2020,NULL
239694,165516,11,28/09/2021,8907025,237676,127712,109963,8669349,N,NULL,9,3/11/2020,NULL
239695,165516,12,28/10/2021,8777716,237676,129309,108367,8540040,N,NULL,9,3/11/2020,NULL
239696,165516,13,28/11/2021,8646791,237676,130925,106750,8409115,N,NULL,9,3/11/2020,NULL
239697,165516,14,28/12/2021,8514229,237676,132562,105114,8276553,N,NULL,9,3/11/2020,NULL
239698,165516,15,28/01/2022,8380010,237676,134219,103457,8142334,N,NULL,9,3/11/2020,NULL
239699,165516,16,28/02/2022,8244114,237676,135896,101779,8006438,N,NULL,9,3/11/2020,NULL
239700,165516,17,28/03/2022,8106519,237676,137595,100080,7868843,N,NULL,9,3/11/2020,NULL
239701,165516,18,28/04/2022,7967204,237676,139315,98361,7729528,N,NULL,9,3/11/2020,NULL
239702,165516,19,28/05/2022,7826147,237676,141057,96619,7588471,N,NULL,9,3/11/2020,NULL
239703,165516,20,28/06/2022,7683327,237676,142820,94856,7445651,N,NULL,9,3/11/2020,NULL
239704,165516,21,28/07/2022,7538722,237676,144605,93071,7301046,N,NULL,9,3/11/2020,NULL
239705,165516,22,28/08/2022,7392309,237676,146413,91263,7154633,N,NULL,9,3/11/2020,NULL
239706,165516,23,28/09/2022,7244066,237676,148243,89433,7006390,N,NULL,9,3/11/2020,NULL
239707,165516,24,28/10/2022,7093970,237676,150096,87580,6856294,N,NULL,9,3/11/2020,NULL
239708,165516,25,28/11/2022,6941998,237676,151972,85704,6704322,N,NULL,9,3/11/2020,NULL
239709,165516,26,28/12/2022,6788126,237676,153872,83804,6550450,N,NULL,9,3/11/2020,NULL
239710,165516,27,28/01/2023,6632331,237676,155795,81881,6394655,N,NULL,9,3/11/2020,NULL
239711,165516,28,28/02/2023,6474589,237676,157742,79933,6236913,N,NULL,9,3/11/2020,NULL
239712,165516,29,28/03/2023,6314875,237676,159714,77961,6077199,N,NULL,9,3/11/2020,NULL
239713,165516,30,28/04/2023,6153164,237676,161711,75965,5915488,N,NULL,9,3/11/2020,NULL
239714,165516,31,28/05/2023,5989432,237676,163732,73944,5751756,N,NULL,9,3/11/2020,NULL
239715,165516,32,28/06/2023,5823653,237676,165779,71897,5585977,N,NULL,9,3/11/2020,NULL
239716,165516,33,28/07/2023,5655802,237676,167851,69825,5418126,N,NULL,9,3/11/2020,NULL
239717,165516,34,28/08/2023,5485853,237676,169949,67727,5248177,N,NULL,9,3/11/2020,NULL
239718,165516,35,28/09/2023,5313780,237676,172073,65602,5076104,N,NULL,9,3/11/2020,NULL
239719,165516,36,28/10/2023,5139556,237676,174224,63451,4901880,N,NULL,9,3/11/2020,NULL
239720,165516,37,28/11/2023,4963154,237676,176402,61273,4725478,N,NULL,9,3/11/2020,NULL
239721,165516,38,28/12/2023,4784547,237676,178607,59068,4546871,N,NULL,9,3/11/2020,NULL
239722,165516,39,28/01/2024,4603707,237676,180840,56836,4366031,N,NULL,9,3/11/2020,NULL
239723,165516,40,28/02/2024,4420607,237676,183100,54575,4182931,N,NULL,9,3/11/2020,NULL
239724,165516,41,28/03/2024,4235218,237676,185389,52287,3997542,N,NULL,9,3/11/2020,NULL
239725,165516,42,28/04/2024,4047512,237676,187706,49969,3809836,N,NULL,9,3/11/2020,NULL
239726,165516,43,28/05/2024,3857459,237676,190053,47623,3619783,N,NULL,9,3/11/2020,NULL
239727,165516,44,28/06/2024,3665031,237676,192428,45247,3427355,N,NULL,9,3/11/2020,NULL
239728,165516,45,28/07/2024,3470197,237676,194834,42842,3232521,N,NULL,9,3/11/2020,NULL
239729,165516,46,28/08/2024,3272928,237676,197269,40406,3035252,N,NULL,9,3/11/2020,NULL
239730,165516,47,28/09/2024,3073193,237676,199735,37941,2835517,N,NULL,9,3/11/2020,NULL
239731,165516,48,28/10/2024,2870961,237676,202232,35444,2633285,N,NULL,9,3/11/2020,NULL
239732,165516,49,28/11/2024,2666201,237676,204760,32916,2428525,N,NULL,9,3/11/2020,NULL
239733,165516,50,28/12/2024,2458882,237676,207319,30357,2221206,N,NULL,9,3/11/2020,NULL
239734,165516,51,28/01/2025,2248971,237676,209911,27765,2011295,N,NULL,9,3/11/2020,NULL
239735,165516,52,28/02/2025,2036437,237676,212534,25141,1798761,N,NULL,9,3/11/2020,NULL
239736,165516,53,28/03/2025,1821246,237676,215191,22484,1583570,N,NULL,9,3/11/2020,NULL
239737,165516,54,28/04/2025,1603365,237676,217881,19795,1365689,N,NULL,9,3/11/2020,NULL
239738,165516,55,28/05/2025,1382760,237676,220605,17071,1145084,N,NULL,9,3/11/2020,NULL
239739,165516,56,28/06/2025,1159398,237676,223362,14314,921722,N,NULL,9,3/11/2020,NULL
239740,165516,57,28/07/2025,933244,237676,226154,11521,695568,N,NULL,9,3/11/2020,NULL
239741,165516,58,28/08/2025,704263,237676,228981,8695,466587,N,NULL,9,3/11/2020,NULL
239742,165516,59,28/09/2025,472420,237676,231843,5832,234744,N,NULL,9,3/11/2020,NULL
239743,165516,60,28/10/2025,237679,237676,234744,2934,0,N,NULL,9,3/11/2020,NULL
239744,165517,1,30/11/2020,3543750,609118,565368,43750,2934632,Y,30/11/2020,9,3/11/2020,275376
239745,165517,2,30/12/2020,2971315,609118,572435,36683,2362197,N,NULL,9,3/11/2020,NULL
239746,165517,3,30/01/2021,2391724,609118,579591,29527,1782606,N,NULL,9,3/11/2020,NULL
239747,165517,4,28/02/2021,1804888,609118,586836,22283,1195770,N,NULL,9,3/11/2020,NULL
239748,165517,5,28/03/2021,1210717,609118,594171,14947,601599,N,NULL,9,3/11/2020,NULL
239749,165517,6,28/04/2021,609119,609118,601599,7520,0,N,NULL,9,3/11/2020,NULL
239750,165518,1,30/11/2020,10115055,734542,609665,124877,9380513,Y,30/11/2020,9,3/11/2020,275375
239751,165518,2,30/12/2020,9497769,734542,617286,117256,8763227,N,NULL,9,3/11/2020,NULL
239752,165518,3,30/01/2021,8872767,734542,625002,109540,8138225,N,NULL,9,3/11/2020,NULL
239753,165518,4,28/02/2021,8239952,734542,632815,101728,7505410,N,NULL,9,3/11/2020,NULL
239754,165518,5,28/03/2021,7599227,734542,640725,93818,6864685,N,NULL,9,3/11/2020,NULL
239755,165518,6,28/04/2021,6950493,734542,648734,85809,6215951,N,NULL,9,3/11/2020,NULL
239756,165518,7,28/05/2021,6293650,734542,656843,77699,5559108,N,NULL,9,3/11/2020,NULL
239757,165518,8,28/06/2021,5628596,734542,665054,69489,4894054,N,NULL,9,3/11/2020,NULL
239758,165518,9,28/07/2021,4955229,734542,673367,61176,4220687,N,NULL,9,3/11/2020,NULL
239759,165518,10,28/08/2021,4273445,734542,681784,52759,3538903,N,NULL,9,3/11/2020,NULL
239760,165518,11,28/09/2021,3583139,734542,690306,44236,2848597,N,NULL,9,3/11/2020,NULL
239761,165518,12,28/10/2021,2884204,734542,698935,35607,2149662,N,NULL,9,3/11/2020,NULL
239762,165518,13,28/11/2021,2176532,734542,707672,26871,1441990,N,NULL,9,3/11/2020,NULL
239763,165518,14,28/12/2021,1460014,734542,716518,18025,725472,N,NULL,9,3/11/2020,NULL
239764,165518,15,28/01/2022,734540,734542,725472,9068,0,N,NULL,9,3/11/2020,NULL
239765,165519,1,30/11/2020,10071530,897817,773477,124340,9173713,Y,30/11/2020,9,3/11/2020,275374
239766,165519,2,30/12/2020,9288385,897817,783145,114671,8390568,N,NULL,9,3/11/2020,NULL
239767,165519,3,30/01/2021,8495451,897817,792934,104882,7597634,N,NULL,9,3/11/2020,NULL
239768,165519,4,28/02/2021,7692605,897817,802846,94970,6794788,N,NULL,9,3/11/2020,NULL
239769,165519,5,28/03/2021,6879723,897817,812882,84935,5981906,N,NULL,9,3/11/2020,NULL
239770,165519,6,28/04/2021,6056680,897817,823043,74774,5158863,N,NULL,9,3/11/2020,NULL
239771,165519,7,28/05/2021,5223349,897817,833331,64486,4325532,N,NULL,9,3/11/2020,NULL
239772,165519,8,28/06/2021,4379602,897817,843747,54069,3481785,N,NULL,9,3/11/2020,NULL
239773,165519,9,28/07/2021,3525308,897817,854294,43522,2627491,N,NULL,9,3/11/2020,NULL
239774,165519,10,28/08/2021,2660335,897817,864973,32844,1762518,N,NULL,9,3/11/2020,NULL
239775,165519,11,28/09/2021,1784550,897817,875785,22031,886733,N,NULL,9,3/11/2020,NULL
239776,165519,12,28/10/2021,897818,897817,886733,11084,0,N,NULL,9,3/11/2020,NULL
239777,165520,1,30/11/2020,3588249,260574,216275,44299,3327675,Y,30/11/2020,9,3/11/2020,275373
239778,165520,2,30/12/2020,3369271,260574,218978,41596,3108697,N,NULL,9,3/11/2020,NULL
239779,165520,3,30/01/2021,3147556,260574,221715,38859,2886982,N,NULL,9,3/11/2020,NULL
239780,165520,4,28/02/2021,2923069,260574,224487,36087,2662495,N,NULL,9,3/11/2020,NULL
239781,165520,5,28/03/2021,2695776,260574,227293,33281,2435202,N,NULL,9,3/11/2020,NULL
239782,165520,6,28/04/2021,2465642,260574,230134,30440,2205068,N,NULL,9,3/11/2020,NULL
239783,165520,7,28/05/2021,2232631,260574,233011,27563,1972057,N,NULL,9,3/11/2020,NULL
239784,165520,8,28/06/2021,1996708,260574,235923,24651,1736134,N,NULL,9,3/11/2020,NULL
239785,165520,9,28/07/2021,1757836,260574,238872,21702,1497262,N,NULL,9,3/11/2020,NULL
239786,165520,10,28/08/2021,1515978,260574,241858,18716,1255404,N,NULL,9,3/11/2020,NULL
239787,165520,11,28/09/2021,1271096,260574,244882,15693,1010522,N,NULL,9,3/11/2020,NULL
239788,165520,12,28/10/2021,1023153,260574,247943,12632,762579,N,NULL,9,3/11/2020,NULL
239789,165520,13,28/11/2021,772111,260574,251042,9532,511537,N,NULL,9,3/11/2020,NULL
239790,165520,14,28/12/2021,517931,260574,254180,6394,257357,N,NULL,9,3/11/2020,NULL
239791,165520,15,28/01/2022,260574,260574,257357,3217,0,N,NULL,9,3/11/2020,NULL
239792,165521,1,30/11/2020,10122241,902337,777371,124966,9219904,Y,30/11/2020,9,3/11/2020,275372
239793,165521,2,30/12/2020,9335153,902337,787088,115249,8432816,N,NULL,9,3/11/2020,NULL
239794,165521,3,30/01/2021,8538226,902337,796927,105410,7635889,N,NULL,9,3/11/2020,NULL
239795,165521,4,28/02/2021,7731337,902337,806889,95449,6829000,N,NULL,9,3/11/2020,NULL
239796,165521,5,28/03/2021,6914362,902337,816975,85362,6012025,N,NULL,9,3/11/2020,NULL
239797,165521,6,28/04/2021,6087175,902337,827187,75150,5184838,N,NULL,9,3/11/2020,NULL
239798,165521,7,28/05/2021,5249648,902337,837527,64810,4347311,N,NULL,9,3/11/2020,NULL
239799,165521,8,28/06/2021,4401652,902337,847996,54341,3499315,N,NULL,9,3/11/2020,NULL
239800,165521,9,28/07/2021,3543056,902337,858596,43741,2640719,N,NULL,9,3/11/2020,NULL
239801,165521,10,28/08/2021,2673728,902337,869328,33009,1771391,N,NULL,9,3/11/2020,NULL
239802,165521,11,28/09/2021,1793533,902337,880195,22142,891196,N,NULL,9,3/11/2020,NULL
239803,165521,12,28/10/2021,902336,902337,891196,11140,0,N,NULL,9,3/11/2020,NULL
239804,165522,1,30/11/2020,7290000,349104,259104,90000,6940896,Y,30/11/2020,9,3/11/2020,275371
239805,165522,2,30/12/2020,7027657,349104,262343,86761,6678553,N,NULL,9,3/11/2020,NULL
239806,165522,3,30/01/2021,6762035,349104,265622,83482,6412931,N,NULL,9,3/11/2020,NULL
239807,165522,4,28/02/2021,6493093,349104,268942,80162,6143989,N,NULL,9,3/11/2020,NULL
239808,165522,5,28/03/2021,6220789,349104,272304,76800,5871685,N,NULL,9,3/11/2020,NULL
239809,165522,6,28/04/2021,5945081,349104,275708,73396,5595977,N,NULL,9,3/11/2020,NULL
239810,165522,7,28/05/2021,5665927,349104,279154,69950,5316823,N,NULL,9,3/11/2020,NULL
239811,165522,8,28/06/2021,5383283,349104,282644,66460,5034179,N,NULL,9,3/11/2020,NULL
239812,165522,9,28/07/2021,5097106,349104,286177,62927,4748002,N,NULL,9,3/11/2020,NULL
239813,165522,10,28/08/2021,4807352,349104,289754,59350,4458248,N,NULL,9,3/11/2020,NULL
239814,165522,11,28/09/2021,4513976,349104,293376,55728,4164872,N,NULL,9,3/11/2020,NULL
239815,165522,12,28/10/2021,4216933,349104,297043,52061,3867829,N,NULL,9,3/11/2020,NULL
239816,165522,13,28/11/2021,3916177,349104,300756,48348,3567073,N,NULL,9,3/11/2020,NULL
239817,165522,14,28/12/2021,3611662,349104,304515,44588,3262558,N,NULL,9,3/11/2020,NULL
239818,165522,15,28/01/2022,3303340,349104,308322,40782,2954236,N,NULL,9,3/11/2020,NULL
239819,165522,16,28/02/2022,2991164,349104,312176,36928,2642060,N,NULL,9,3/11/2020,NULL
239820,165522,17,28/03/2022,2675086,349104,316078,33026,2325982,N,NULL,9,3/11/2020,NULL
239821,165522,18,28/04/2022,2355057,349104,320029,29075,2005953,N,NULL,9,3/11/2020,NULL
239822,165522,19,28/05/2022,2031028,349104,324029,25074,1681924,N,NULL,9,3/11/2020,NULL
239823,165522,20,28/06/2022,1702948,349104,328080,21024,1353844,N,NULL,9,3/11/2020,NULL
239824,165522,21,28/07/2022,1370767,349104,332181,16923,1021663,N,NULL,9,3/11/2020,NULL
239825,165522,22,28/08/2022,1034434,349104,336333,12771,685330,N,NULL,9,3/11/2020,NULL
239826,165522,23,28/09/2022,693897,349104,340537,8567,344793,N,NULL,9,3/11/2020,NULL
239827,165522,24,28/10/2022,349103,349104,344793,4310,0,N,NULL,9,3/11/2020,NULL
239828,165523,1,3/12/2020,709917,709917,700000,9917,0,Y,3/12/2020,9,3/11/2020,275630
239829,165524,1,3/12/2020,2531250,644653,613403,31250,1886597,Y,3/12/2020,9,3/11/2020,275629
239830,165524,2,3/1/2021,1910180,644653,621070,23582,1265527,N,NULL,9,3/11/2020,NULL
239831,165524,3,3/2/2021,1281347,644653,628833,15819,636694,N,NULL,9,3/11/2020,NULL
239832,165524,4,3/3/2021,644653,644653,636694,7959,0,N,NULL,9,3/11/2020,NULL
239833,165525,1,3/12/2020,10125000,568204,443204,125000,9556796,Y,3/12/2020,9,3/11/2020,275628
239834,165525,2,3/1/2021,9676256,568204,448744,119460,9108052,N,NULL,9,3/11/2020,NULL
239835,165525,3,3/2/2021,9221903,568204,454353,113851,8653699,N,NULL,9,3/11/2020,NULL
239836,165525,4,3/3/2021,8761870,568204,460033,108171,8193666,N,NULL,9,3/11/2020,NULL
239837,165525,5,3/4/2021,8296087,568204,465783,102421,7727883,N,NULL,9,3/11/2020,NULL
239838,165525,6,3/5/2021,7824482,568204,471605,96599,7256278,N,NULL,9,3/11/2020,NULL
239839,165525,7,3/6/2021,7346982,568204,477500,90703,6778778,N,NULL,9,3/11/2020,NULL
239840,165525,8,3/7/2021,6863513,568204,483469,84735,6295309,N,NULL,9,3/11/2020,NULL
239841,165525,9,3/8/2021,6374000,568204,489513,78691,5805796,N,NULL,9,3/11/2020,NULL
239842,165525,10,3/9/2021,5878369,568204,495631,72572,5310165,N,NULL,9,3/11/2020,NULL
239843,165525,11,3/10/2021,5376542,568204,501827,66377,4808338,N,NULL,9,3/11/2020,NULL
239844,165525,12,3/11/2021,4868442,568204,508100,60104,4300238,N,NULL,9,3/11/2020,NULL
239845,165525,13,3/12/2021,4353991,568204,514451,53753,3785787,N,NULL,9,3/11/2020,NULL
239846,165525,14,3/1/2022,3833109,568204,520882,47322,3264905,N,NULL,9,3/11/2020,NULL
239847,165525,15,3/2/2022,3305716,568204,527393,40811,2737512,N,NULL,9,3/11/2020,NULL
239848,165525,16,3/3/2022,2771731,568204,533985,34219,2203527,N,NULL,9,3/11/2020,NULL
239849,165525,17,3/4/2022,2231071,568204,540660,27544,1662867,N,NULL,9,3/11/2020,NULL
239850,165525,18,3/5/2022,1683653,568204,547418,20786,1115449,N,NULL,9,3/11/2020,NULL
239851,165525,19,3/6/2022,1129392,568204,554261,13943,561188,N,NULL,9,3/11/2020,NULL
239852,165525,20,3/7/2022,568203,568204,561188,7015,0,N,NULL,9,3/11/2020,NULL
239853,165526,1,3/12/2020,2227500,751743,724243,27500,1475757,Y,3/12/2020,9,3/11/2020,275627
239854,165526,2,3/1/2021,1494204,751743,733296,18447,742461,N,NULL,9,3/11/2020,NULL
239855,165526,3,3/2/2021,751742,751743,742461,9281,0,N,NULL,9,3/11/2020,NULL
239856,165309,1,13/11/2020,8199352,460139,358912,101227,7739213,Y,13/11/2020,9,4/11/2020,274585
239857,165309,2,13/12/2020,7835954,460139,363398,96740,7375815,Y,13/12/2020,9,4/11/2020,276217
239858,165309,3,13/01/2021,7468013,460139,367941,92198,7007874,N,NULL,9,4/11/2020,NULL
239859,165309,4,13/02/2021,7095473,460139,372540,87598,6635334,N,NULL,9,4/11/2020,NULL
239860,165309,5,13/03/2021,6718276,460139,377197,82942,6258137,N,NULL,9,4/11/2020,NULL
239861,165309,6,13/04/2021,6336364,460139,381912,78227,5876225,N,NULL,9,4/11/2020,NULL
239862,165309,7,13/05/2021,5949678,460139,386686,73453,5489539,N,NULL,9,4/11/2020,NULL
239863,165309,8,13/06/2021,5558159,460139,391519,68619,5098020,N,NULL,9,4/11/2020,NULL
239864,165309,9,13/07/2021,5161746,460139,396413,63725,4701607,N,NULL,9,4/11/2020,NULL
239865,165309,10,13/08/2021,4760377,460139,401369,58770,4300238,N,NULL,9,4/11/2020,NULL
239866,165309,11,13/09/2021,4353991,460139,406386,53753,3893852,N,NULL,9,4/11/2020,NULL
239867,165309,12,13/10/2021,3942526,460139,411465,48673,3482387,N,NULL,9,4/11/2020,NULL
239868,165309,13,13/11/2021,3525917,460139,416609,43530,3065778,N,NULL,9,4/11/2020,NULL
239869,165309,14,13/12/2021,3104101,460139,421816,38322,2643962,N,NULL,9,4/11/2020,NULL
239870,165309,15,13/01/2022,2677012,460139,427089,33050,2216873,N,NULL,9,4/11/2020,NULL
239871,165309,16,13/02/2022,2244584,460139,432428,27711,1784445,N,NULL,9,4/11/2020,NULL
239872,165309,17,13/03/2022,1806751,460139,437833,22306,1346612,N,NULL,9,4/11/2020,NULL
239873,165309,18,13/04/2022,1363445,460139,443306,16833,903306,N,NULL,9,4/11/2020,NULL
239874,165309,19,13/05/2022,914598,460139,448847,11291,454459,N,NULL,9,4/11/2020,NULL
239875,165309,20,13/06/2022,460140,460139,454459,5681,0,N,NULL,9,4/11/2020,NULL
239876,165527,1,4/12/2020,1012500,257861,245361,12500,754639,Y,4/12/2020,9,5/11/2020,275722
239877,165527,2,4/1/2021,764072,257861,248428,9433,506211,N,NULL,9,5/11/2020,NULL
239878,165527,3,4/2/2021,512539,257861,251533,6328,254678,N,NULL,9,5/11/2020,NULL
239879,165527,4,4/3/2021,257861,257861,254678,3183,0,N,NULL,9,5/11/2020,NULL
239880,165528,1,4/12/2020,1012500,174034,161534,12500,838466,Y,4/12/2020,9,5/11/2020,275721
239881,165528,2,4/1/2021,848947,174034,163553,10481,674913,N,NULL,9,5/11/2020,NULL
239882,165528,3,4/2/2021,683350,174034,165597,8436,509316,N,NULL,9,5/11/2020,NULL
239883,165528,4,4/3/2021,515683,174034,167667,6366,341649,N,NULL,9,5/11/2020,NULL
239884,165528,5,4/4/2021,345920,174034,169763,4271,171886,N,NULL,9,5/11/2020,NULL
239885,165528,6,4/5/2021,174035,174034,171886,2149,0,N,NULL,9,5/11/2020,NULL
239886,165529,1,4/12/2020,1113750,283647,269897,13750,830103,Y,4/12/2020,9,5/11/2020,275720
239887,165529,2,4/1/2021,840479,283647,273271,10376,556832,N,NULL,9,5/11/2020,NULL
239888,165529,3,4/2/2021,563792,283647,276687,6960,280145,N,NULL,9,5/11/2020,NULL
239889,165529,4,4/3/2021,283647,283647,280145,3502,0,N,NULL,9,5/11/2020,NULL
239890,165530,1,4/12/2020,3037500,522101,484601,37500,2515399,Y,4/12/2020,9,5/11/2020,275719
239891,165530,2,4/1/2021,2546841,522101,490659,31442,2024740,N,NULL,9,5/11/2020,NULL
239892,165530,3,4/2/2021,2050049,522101,496792,25309,1527948,N,NULL,9,5/11/2020,NULL
239893,165530,4,4/3/2021,1547047,522101,503002,19099,1024946,N,NULL,9,5/11/2020,NULL
239894,165530,5,4/4/2021,1037757,522101,509290,12812,515656,N,NULL,9,5/11/2020,NULL
239895,165530,6,4/5/2021,522101,522101,515656,6446,0,N,NULL,9,5/11/2020,NULL
239896,165531,1,4/12/2020,6201007,1065862,989306,76556,5135145,Y,4/12/2020,9,5/11/2020,275718
239897,165531,2,4/1/2021,5199335,1065862,1001672,64189,4133473,N,NULL,9,5/11/2020,NULL
239898,165531,3,4/2/2021,4185142,1065862,1014193,51668,3119280,N,NULL,9,5/11/2020,NULL
239899,165531,4,4/3/2021,3158271,1065862,1026871,38991,2092409,N,NULL,9,5/11/2020,NULL
239900,165531,5,4/4/2021,2118565,1065862,1039706,26155,1052703,N,NULL,9,5/11/2020,NULL
239901,165531,6,4/5/2021,1065862,1065862,1052703,13159,0,N,NULL,9,5/11/2020,NULL
239902,165532,1,4/12/2020,10122922,1321060,1196086,124974,8801862,Y,4/12/2020,9,5/11/2020,275717
239903,165532,2,4/1/2021,8911885,1321060,1211037,110023,7590825,N,NULL,9,5/11/2020,NULL
239904,165532,3,4/2/2021,7685710,1321060,1226175,94885,6364650,N,NULL,9,5/11/2020,NULL
239905,165532,4,4/3/2021,6444208,1321060,1241502,79558,5123148,N,NULL,9,5/11/2020,NULL
239906,165532,5,4/4/2021,5187187,1321060,1257021,64039,3866127,N,NULL,9,5/11/2020,NULL
239907,165532,6,4/5/2021,3914453,1321060,1272734,48327,2593393,N,NULL,9,5/11/2020,NULL
239908,165532,7,4/6/2021,2625810,1321060,1288643,32417,1304750,N,NULL,9,5/11/2020,NULL
239909,165532,8,4/7/2021,1321059,1321060,1304750,16309,0,N,NULL,9,5/11/2020,NULL
239910,165533,1,4/12/2020,1012500,509394,496894,12500,503106,Y,4/12/2020,9,5/11/2020,275716
239911,165533,2,11/12/2020,509394,509394,503106,6289,0,Y,11/12/2020,9,5/11/2020,276167
239912,165534,1,4/12/2020,40500000,951597,451597,500000,39548403,Y,4/12/2020,9,5/11/2020,275715
239913,165534,2,4/1/2021,40042758,951597,457242,494355,39091161,N,NULL,9,5/11/2020,NULL
239914,165534,3,4/2/2021,39579800,951597,462958,488640,38628203,N,NULL,9,5/11/2020,NULL
239915,165534,4,4/3/2021,39111055,951597,468745,482853,38159458,N,NULL,9,5/11/2020,NULL
239916,165534,5,4/4/2021,38636451,951597,474604,476993,37684854,N,NULL,9,5/11/2020,NULL
239917,165534,6,4/5/2021,38155914,951597,480537,471061,37204317,N,NULL,9,5/11/2020,NULL
239918,165534,7,4/6/2021,37669371,951597,486543,465054,36717774,N,NULL,9,5/11/2020,NULL
239919,165534,8,4/7/2021,37176746,951597,492625,458972,36225149,N,NULL,9,5/11/2020,NULL
239920,165534,9,4/8/2021,36677963,951597,498783,452814,35726366,N,NULL,9,5/11/2020,NULL
239921,165534,10,4/9/2021,36172945,951597,505018,446580,35221348,N,NULL,9,5/11/2020,NULL
239922,165534,11,4/10/2021,35661615,951597,511330,440267,34710018,N,NULL,9,5/11/2020,NULL
239923,165534,12,4/11/2021,35143893,951597,517722,433875,34192296,N,NULL,9,5/11/2020,NULL
239924,165534,13,4/12/2021,34619700,951597,524193,427404,33668103,N,NULL,9,5/11/2020,NULL
239925,165534,14,4/1/2022,34088954,951597,530746,420851,33137357,N,NULL,9,5/11/2020,NULL
239926,165534,15,4/2/2022,33551574,951597,537380,414217,32599977,N,NULL,9,5/11/2020,NULL
239927,165534,16,4/3/2022,33007477,951597,544097,407500,32055880,N,NULL,9,5/11/2020,NULL
239928,165534,17,4/4/2022,32456578,951597,550899,400698,31504981,N,NULL,9,5/11/2020,NULL
239929,165534,18,4/5/2022,31898793,951597,557785,393812,30947196,N,NULL,9,5/11/2020,NULL
239930,165534,19,4/6/2022,31334036,951597,564757,386840,30382439,N,NULL,9,5/11/2020,NULL
239931,165534,20,4/7/2022,30762219,951597,571817,379780,29810622,N,NULL,9,5/11/2020,NULL
239932,165534,21,4/8/2022,30183255,951597,578964,372633,29231658,N,NULL,9,5/11/2020,NULL
239933,165534,22,4/9/2022,29597054,951597,586201,365396,28645457,N,NULL,9,5/11/2020,NULL
239934,165534,23,4/10/2022,29003525,951597,593529,358068,28051928,N,NULL,9,5/11/2020,NULL
239935,165534,24,4/11/2022,28402577,951597,600948,350649,27450980,N,NULL,9,5/11/2020,NULL
239936,165534,25,4/12/2022,27794117,951597,608460,343137,26842520,N,NULL,9,5/11/2020,NULL
239937,165534,26,4/1/2023,27178051,951597,616066,335531,26226454,N,NULL,9,5/11/2020,NULL
239938,165534,27,4/2/2023,26554284,951597,623767,327831,25602687,N,NULL,9,5/11/2020,NULL
239939,165534,28,4/3/2023,25922720,951597,631564,320034,24971123,N,NULL,9,5/11/2020,NULL
239940,165534,29,4/4/2023,25283262,951597,639458,312139,24331665,N,NULL,9,5/11/2020,NULL
239941,165534,30,4/5/2023,24635811,951597,647451,304146,23684214,N,NULL,9,5/11/2020,NULL
239942,165534,31,4/6/2023,23980266,951597,655545,296053,23028669,N,NULL,9,5/11/2020,NULL
239943,165534,32,4/7/2023,23316527,951597,663739,287858,22364930,N,NULL,9,5/11/2020,NULL
239944,165534,33,4/8/2023,22644491,951597,672036,279562,21692894,N,NULL,9,5/11/2020,NULL
239945,165534,34,4/9/2023,21964055,951597,680436,271161,21012458,N,NULL,9,5/11/2020,NULL
239946,165534,35,4/10/2023,21275114,951597,688941,262656,20323517,N,NULL,9,5/11/2020,NULL
239947,165534,36,4/11/2023,20577561,951597,697553,254044,19625964,N,NULL,9,5/11/2020,NULL
239948,165534,37,4/12/2023,19871288,951597,706273,245325,18919691,N,NULL,9,5/11/2020,NULL
239949,165534,38,4/1/2024,19156187,951597,715101,236496,18204590,N,NULL,9,5/11/2020,NULL
239950,165534,39,4/2/2024,18432147,951597,724040,227557,17480550,N,NULL,9,5/11/2020,NULL
239951,165534,40,4/3/2024,17699057,951597,733090,218507,16747460,N,NULL,9,5/11/2020,NULL
239952,165534,41,4/4/2024,16956803,951597,742254,209343,16005206,N,NULL,9,5/11/2020,NULL
239953,165534,42,4/5/2024,16205271,951597,751532,200065,15253674,N,NULL,9,5/11/2020,NULL
239954,165534,43,4/6/2024,15444345,951597,760926,190671,14492748,N,NULL,9,5/11/2020,NULL
239955,165534,44,4/7/2024,14673907,951597,770438,181159,13722310,N,NULL,9,5/11/2020,NULL
239956,165534,45,4/8/2024,13893839,951597,780068,171529,12942242,N,NULL,9,5/11/2020,NULL
239957,165534,46,4/9/2024,13104020,951597,789819,161778,12152423,N,NULL,9,5/11/2020,NULL
239958,165534,47,4/10/2024,12304328,951597,799692,151905,11352731,N,NULL,9,5/11/2020,NULL
239959,165534,48,4/11/2024,11494640,951597,809688,141909,10543043,N,NULL,9,5/11/2020,NULL
239960,165534,49,4/12/2024,10674831,951597,819809,131788,9723234,N,NULL,9,5/11/2020,NULL
239961,165534,50,4/1/2025,9844774,951597,830057,121540,8893177,N,NULL,9,5/11/2020,NULL
239962,165534,51,4/2/2025,9004342,951597,840432,111165,8052745,N,NULL,9,5/11/2020,NULL
239963,165534,52,4/3/2025,8153404,951597,850938,100659,7201807,N,NULL,9,5/11/2020,NULL
239964,165534,53,4/4/2025,7291829,951597,861575,90023,6340232,N,NULL,9,5/11/2020,NULL
239965,165534,54,4/5/2025,6419485,951597,872344,79253,5467888,N,NULL,9,5/11/2020,NULL
239966,165534,55,4/6/2025,5536236,951597,883249,68349,4584639,N,NULL,9,5/11/2020,NULL
239967,165534,56,4/7/2025,4641947,951597,894289,57308,3690350,N,NULL,9,5/11/2020,NULL
239968,165534,57,4/8/2025,3736479,951597,905468,46129,2784882,N,NULL,9,5/11/2020,NULL
239969,165534,58,4/9/2025,2819693,951597,916786,34811,1868096,N,NULL,9,5/11/2020,NULL
239970,165534,59,4/10/2025,1891447,951597,928246,23351,939850,N,NULL,9,5/11/2020,NULL
239971,165534,60,4/11/2025,951598,951597,939850,11748,0,N,NULL,9,5/11/2020,NULL
239972,165535,1,4/12/2020,55687500,1308446,620946,687500,54379054,Y,4/12/2020,9,5/11/2020,275714
239973,165535,2,4/1/2021,55058792,1308446,628708,679738,53750346,N,NULL,9,5/11/2020,NULL
239974,165535,3,4/2/2021,54422225,1308446,636567,671879,53113779,N,NULL,9,5/11/2020,NULL
239975,165535,4,4/3/2021,53777701,1308446,644524,663922,52469255,N,NULL,9,5/11/2020,NULL
239976,165535,5,4/4/2021,53125121,1308446,652580,655866,51816675,N,NULL,9,5/11/2020,NULL
239977,165535,6,4/5/2021,52464383,1308446,660738,647708,51155937,N,NULL,9,5/11/2020,NULL
239978,165535,7,4/6/2021,51795386,1308446,668997,639449,50486940,N,NULL,9,5/11/2020,NULL
239979,165535,8,4/7/2021,51118027,1308446,677359,631087,49809581,N,NULL,9,5/11/2020,NULL
239980,165535,9,4/8/2021,50432201,1308446,685826,622620,49123755,N,NULL,9,5/11/2020,NULL
239981,165535,10,4/9/2021,49737802,1308446,694399,614047,48429356,N,NULL,9,5/11/2020,NULL
239982,165535,11,4/10/2021,49034723,1308446,703079,605367,47726277,N,NULL,9,5/11/2020,NULL
239983,165535,12,4/11/2021,48322855,1308446,711868,596578,47014409,N,NULL,9,5/11/2020,NULL
239984,165535,13,4/12/2021,47602089,1308446,720766,587680,46293643,N,NULL,9,5/11/2020,NULL
239985,165535,14,4/1/2022,46872313,1308446,729776,578671,45563867,N,NULL,9,5/11/2020,NULL
239986,165535,15,4/2/2022,46133415,1308446,738898,569548,44824969,N,NULL,9,5/11/2020,NULL
239987,165535,16,4/3/2022,45385281,1308446,748134,560312,44076835,N,NULL,9,5/11/2020,NULL
239988,165535,17,4/4/2022,44627795,1308446,757486,550960,43319349,N,NULL,9,5/11/2020,NULL
239989,165535,18,4/5/2022,43860841,1308446,766954,541492,42552395,N,NULL,9,5/11/2020,NULL
239990,165535,19,4/6/2022,43084300,1308446,776541,531905,41775854,N,NULL,9,5/11/2020,NULL
239991,165535,20,4/7/2022,42298052,1308446,786248,522198,40989606,N,NULL,9,5/11/2020,NULL
239992,165535,21,4/8/2022,41501976,1308446,796076,512370,40193530,N,NULL,9,5/11/2020,NULL
239993,165535,22,4/9/2022,40695949,1308446,806027,502419,39387503,N,NULL,9,5/11/2020,NULL
239994,165535,23,4/10/2022,39879847,1308446,816102,492344,38571401,N,NULL,9,5/11/2020,NULL
239995,165535,24,4/11/2022,39053543,1308446,826304,482142,37745097,N,NULL,9,5/11/2020,NULL
239996,165535,25,4/12/2022,38216911,1308446,836632,471814,36908465,N,NULL,9,5/11/2020,NULL
239997,165535,26,4/1/2023,37369821,1308446,847090,461356,36061375,N,NULL,9,5/11/2020,NULL
239998,165535,27,4/2/2023,36512142,1308446,857679,450767,35203696,N,NULL,9,5/11/2020,NULL
239999,165535,28,4/3/2023,35643742,1308446,868400,440046,34335296,N,NULL,9,5/11/2020,NULL
240000,165535,29,4/4/2023,34764487,1308446,879255,429191,33456041,N,NULL,9,5/11/2020,NULL
240001,165535,30,4/5/2023,33874241,1308446,890246,418200,32565795,N,NULL,9,5/11/2020,NULL
240002,165535,31,4/6/2023,32972867,1308446,901374,407072,31664421,N,NULL,9,5/11/2020,NULL
240003,165535,32,4/7/2023,32060226,1308446,912641,395805,30751780,N,NULL,9,5/11/2020,NULL
240004,165535,33,4/8/2023,31136177,1308446,924049,384397,29827731,N,NULL,9,5/11/2020,NULL
240005,165535,34,4/9/2023,30200577,1308446,935600,372847,28892131,N,NULL,9,5/11/2020,NULL
240006,165535,35,4/10/2023,29253282,1308446,947295,361152,27944836,N,NULL,9,5/11/2020,NULL
240007,165535,36,4/11/2023,28294146,1308446,959136,349310,26985700,N,NULL,9,5/11/2020,NULL
240008,165535,37,4/12/2023,27323021,1308446,971125,337321,26014575,N,NULL,9,5/11/2020,NULL
240009,165535,38,4/1/2024,26339757,1308446,983264,325182,25031311,N,NULL,9,5/11/2020,NULL
240010,165535,39,4/2/2024,25344202,1308446,995555,312891,24035756,N,NULL,9,5/11/2020,NULL
240011,165535,40,4/3/2024,24336203,1308446,1007999,300447,23027757,N,NULL,9,5/11/2020,NULL
240012,165535,41,4/4/2024,23315604,1308446,1020599,287847,22007158,N,NULL,9,5/11/2020,NULL
240013,165535,42,4/5/2024,22282247,1308446,1033357,275089,20973801,N,NULL,9,5/11/2020,NULL
240014,165535,43,4/6/2024,21235973,1308446,1046274,262173,19927527,N,NULL,9,5/11/2020,NULL
240015,165535,44,4/7/2024,20176621,1308446,1059352,249094,18868175,N,NULL,9,5/11/2020,NULL
240016,165535,45,4/8/2024,19104027,1308446,1072594,235852,17795581,N,NULL,9,5/11/2020,NULL
240017,165535,46,4/9/2024,18018026,1308446,1086001,222445,16709580,N,NULL,9,5/11/2020,NULL
240018,165535,47,4/10/2024,16918450,1308446,1099576,208870,15610004,N,NULL,9,5/11/2020,NULL
240019,165535,48,4/11/2024,15805129,1308446,1113321,195125,14496683,N,NULL,9,5/11/2020,NULL
240020,165535,49,4/12/2024,14677891,1308446,1127238,181209,13369445,N,NULL,9,5/11/2020,NULL
240021,165535,50,4/1/2025,13536563,1308446,1141328,167118,12228117,N,NULL,9,5/11/2020,NULL
240022,165535,51,4/2/2025,12380968,1308446,1155595,152851,11072522,N,NULL,9,5/11/2020,NULL
240023,165535,52,4/3/2025,11210928,1308446,1170040,138407,9902482,N,NULL,9,5/11/2020,NULL
240024,165535,53,4/4/2025,10026263,1308446,1184665,123781,8717817,N,NULL,9,5/11/2020,NULL
240025,165535,54,4/5/2025,8826790,1308446,1199473,108973,7518344,N,NULL,9,5/11/2020,NULL
240026,165535,55,4/6/2025,7612323,1308446,1214467,93979,6303877,N,NULL,9,5/11/2020,NULL
240027,165535,56,4/7/2025,6382675,1308446,1229648,78798,5074229,N,NULL,9,5/11/2020,NULL
240028,165535,57,4/8/2025,5137657,1308446,1245018,63428,3829211,N,NULL,9,5/11/2020,NULL
240029,165535,58,4/9/2025,3877076,1308446,1260581,47865,2568630,N,NULL,9,5/11/2020,NULL
240030,165535,59,4/10/2025,2600738,1308446,1276338,32108,1292292,N,NULL,9,5/11/2020,NULL
240031,165535,60,4/11/2025,1308446,1308446,1292292,16154,0,N,NULL,9,5/11/2020,NULL
240032,165536,1,4/12/2020,3633554,925385,880526,44859,2708169,C,4/12/2020,9,6/11/2020,275838
240033,165536,2,4/12/2020,2742022,925385,891532,0,1816637,C,4/12/2020,9,6/11/2020,NULL
240034,165536,3,4/12/2020,1839345,925385,902677,0,913960,C,4/12/2020,9,6/11/2020,NULL
240035,165536,4,4/12/2020,925385,925385,913960,0,0,C,4/12/2020,9,6/11/2020,NULL
240036,165537,1,5/12/2020,1518750,386792,368042,18750,1131958,Y,5/12/2020,9,6/11/2020,275837
240037,165537,2,5/1/2021,1146108,386792,372642,14149,759316,N,NULL,9,6/11/2020,NULL
240038,165537,3,5/2/2021,768808,386792,377300,9491,382016,N,NULL,9,6/11/2020,NULL
240039,165537,4,5/3/2021,386792,386792,382016,4775,0,N,NULL,9,6/11/2020,NULL
240040,165538,1,5/12/2020,15187500,727300,539800,187500,14460200,Y,5/12/2020,9,6/11/2020,275836
240041,165538,2,5/1/2021,14640953,727300,546547,180753,13913653,N,NULL,9,6/11/2020,NULL
240042,165538,3,5/2/2021,14087574,727300,553379,173921,13360274,N,NULL,9,6/11/2020,NULL
240043,165538,4,5/3/2021,13527278,727300,560296,167003,12799978,N,NULL,9,6/11/2020,NULL
240044,165538,5,5/4/2021,12959978,727300,567300,160000,12232678,N,NULL,9,6/11/2020,NULL
240045,165538,6,5/5/2021,12385587,727300,574391,152908,11658287,N,NULL,9,6/11/2020,NULL
240046,165538,7,5/6/2021,11804016,727300,581571,145729,11076716,N,NULL,9,6/11/2020,NULL
240047,165538,8,5/7/2021,11215175,727300,588841,138459,10487875,N,NULL,9,6/11/2020,NULL
240048,165538,9,5/8/2021,10618974,727300,596201,131098,9891674,N,NULL,9,6/11/2020,NULL
240049,165538,10,5/9/2021,10015320,727300,603654,123646,9288020,N,NULL,9,6/11/2020,NULL
240050,165538,11,5/10/2021,9404121,727300,611199,116100,8676821,N,NULL,9,6/11/2020,NULL
240051,165538,12,5/11/2021,8785282,727300,618839,108460,8057982,N,NULL,9,6/11/2020,NULL
240052,165538,13,5/12/2021,8158707,727300,626575,100725,7431407,N,NULL,9,6/11/2020,NULL
240053,165538,14,5/1/2022,7524300,727300,634407,92893,6797000,N,NULL,9,6/11/2020,NULL
240054,165538,15,5/2/2022,6881963,727300,642337,84962,6154663,N,NULL,9,6/11/2020,NULL
240055,165538,16,5/3/2022,6231597,727300,650366,76933,5504297,N,NULL,9,6/11/2020,NULL
240056,165538,17,5/4/2022,5573101,727300,658496,68804,4845801,N,NULL,9,6/11/2020,NULL
240057,165538,18,5/5/2022,4906374,727300,666727,60572,4179074,N,NULL,9,6/11/2020,NULL
240058,165538,19,5/6/2022,4231313,727300,675061,52238,3504013,N,NULL,9,6/11/2020,NULL
240059,165538,20,5/7/2022,3547813,727300,683500,43800,2820513,N,NULL,9,6/11/2020,NULL
240060,165538,21,5/8/2022,2855770,727300,692043,35256,2128470,N,NULL,9,6/11/2020,NULL
240061,165538,22,5/9/2022,2155076,727300,700694,26606,1427776,N,NULL,9,6/11/2020,NULL
240062,165538,23,5/10/2022,1445623,727300,709453,17847,718323,N,NULL,9,6/11/2020,NULL
240063,165538,24,5/11/2022,727302,727300,718323,8979,0,N,NULL,9,6/11/2020,NULL
240064,165539,1,5/12/2020,4050000,830248,780248,50000,3219752,Y,5/12/2020,9,6/11/2020,275835
240065,165539,2,5/1/2021,3259998,830248,790002,40247,2429750,N,NULL,9,6/11/2020,NULL
240066,165539,3,5/2/2021,2460121,830248,799877,30372,1629873,N,NULL,9,6/11/2020,NULL
240067,165539,4,5/3/2021,1650246,830248,809875,20373,819998,N,NULL,9,6/11/2020,NULL
240068,165539,5,5/4/2021,830248,830248,819998,10250,0,N,NULL,9,6/11/2020,NULL
240069,165540,1,5/12/2020,4565722,482515,426148,56367,4083207,Y,5/12/2020,9,6/11/2020,275834
240070,165540,2,5/1/2021,4134247,482515,431475,51040,3651732,N,NULL,9,6/11/2020,NULL
240071,165540,3,5/2/2021,3697379,482515,436868,45647,3214864,N,NULL,9,6/11/2020,NULL
240072,165540,4,5/3/2021,3255050,482515,442329,40186,2772535,N,NULL,9,6/11/2020,NULL
240073,165540,5,5/4/2021,2807192,482515,447858,34657,2324677,N,NULL,9,6/11/2020,NULL
240074,165540,6,5/5/2021,2353736,482515,453456,29058,1871221,N,NULL,9,6/11/2020,NULL
240075,165540,7,5/6/2021,1894611,482515,459125,23390,1412096,N,NULL,9,6/11/2020,NULL
240076,165540,8,5/7/2021,1429747,482515,464864,17651,947232,N,NULL,9,6/11/2020,NULL
240077,165540,9,5/8/2021,959073,482515,470674,11840,476558,N,NULL,9,6/11/2020,NULL
240078,165540,10,5/9/2021,482515,482515,476558,5957,0,N,NULL,9,6/11/2020,NULL
240079,165541,1,5/12/2020,2028333,685644,657311,28333,1342689,Y,5/12/2020,9,6/11/2020,275833
240080,165541,2,5/1/2021,1361710,685644,666623,19021,676066,N,NULL,9,6/11/2020,NULL
240081,165541,3,5/2/2021,685643,685644,676066,9578,0,N,NULL,9,6/11/2020,NULL
240082,165542,1,5/12/2020,811334,274258,262924,11333,537076,N,NULL,9,6/11/2020,NULL
240083,165542,2,5/1/2021,544685,274258,266649,7609,270427,N,NULL,9,6/11/2020,NULL
240084,165542,3,5/2/2021,274258,274258,270427,3831,0,N,NULL,9,6/11/2020,NULL
240085,165543,1,6/11/2020,50669835,1190550,564996,625554,49479285,Y,9/11/2020,10,7/11/2020,274447
240086,165543,2,6/12/2020,50097776,1190550,572059,618491,48907226,Y,6/12/2020,10,7/11/2020,275855
240087,165543,3,6/1/2021,49518566,1190550,579210,611340,48328016,N,NULL,10,7/11/2020,NULL
240088,165543,4,6/2/2021,48932116,1190550,586450,604100,47741566,N,NULL,10,7/11/2020,NULL
240089,165543,5,6/3/2021,48338336,1190550,593780,596770,47147786,N,NULL,10,7/11/2020,NULL
240090,165543,6,6/4/2021,47737133,1190550,601203,589347,46546583,N,NULL,10,7/11/2020,NULL
240091,165543,7,6/5/2021,47128415,1190550,608718,581832,45937865,N,NULL,10,7/11/2020,NULL
240092,165543,8,6/6/2021,46512088,1190550,616327,574223,45321538,N,NULL,10,7/11/2020,NULL
240093,165543,9,6/7/2021,45888057,1190550,624031,566519,44697507,N,NULL,10,7/11/2020,NULL
240094,165543,10,6/8/2021,45256226,1190550,631831,558719,44065676,N,NULL,10,7/11/2020,NULL
240095,165543,11,6/9/2021,44616497,1190550,639729,550821,43425947,N,NULL,10,7/11/2020,NULL
240096,165543,12,6/10/2021,43968771,1190550,647726,542824,42778221,N,NULL,10,7/11/2020,NULL
240097,165543,13,6/11/2021,43312949,1190550,655822,534728,42122399,N,NULL,10,7/11/2020,NULL
240098,165543,14,6/12/2021,42648929,1190550,664020,526530,41458379,N,NULL,10,7/11/2020,NULL
240099,165543,15,6/1/2022,41976609,1190550,672320,518230,40786059,N,NULL,10,7/11/2020,NULL
240100,165543,16,6/2/2022,41295885,1190550,680724,509826,40105335,N,NULL,10,7/11/2020,NULL
240101,165543,17,6/3/2022,40606652,1190550,689233,501317,39416102,N,NULL,10,7/11/2020,NULL
240102,165543,18,6/4/2022,39908803,1190550,697849,492701,38718253,N,NULL,10,7/11/2020,NULL
240103,165543,19,6/5/2022,39202231,1190550,706572,483978,38011681,N,NULL,10,7/11/2020,NULL
240104,165543,20,6/6/2022,38486827,1190550,715404,475146,37296277,N,NULL,10,7/11/2020,NULL
240105,165543,21,6/7/2022,37762481,1190550,724346,466203,36571931,N,NULL,10,7/11/2020,NULL
240106,165543,22,6/8/2022,37029080,1190550,733401,457149,35838530,N,NULL,10,7/11/2020,NULL
240107,165543,23,6/9/2022,36286512,1190550,742568,447982,35095962,N,NULL,10,7/11/2020,NULL
240108,165543,24,6/10/2022,35534662,1190550,751850,438700,34344112,N,NULL,10,7/11/2020,NULL
240109,165543,25,6/11/2022,34773413,1190550,761249,429301,33582863,N,NULL,10,7/11/2020,NULL
240110,165543,26,6/12/2022,34002649,1190550,770764,419786,32812099,N,NULL,10,7/11/2020,NULL
240111,165543,27,6/1/2023,33222250,1190550,780399,410151,32031700,N,NULL,10,7/11/2020,NULL
240112,165543,28,6/2/2023,32432096,1190550,790154,400396,31241546,N,NULL,10,7/11/2020,NULL
240113,165543,29,6/3/2023,31632065,1190550,800031,390519,30441515,N,NULL,10,7/11/2020,NULL
240114,165543,30,6/4/2023,30822034,1190550,810031,380519,29631484,N,NULL,10,7/11/2020,NULL
240115,165543,31,6/5/2023,30001878,1190550,820156,370394,28811328,N,NULL,10,7/11/2020,NULL
240116,165543,32,6/6/2023,29171470,1190550,830408,360142,27980920,N,NULL,10,7/11/2020,NULL
240117,165543,33,6/7/2023,28330682,1190550,840788,349762,27140132,N,NULL,10,7/11/2020,NULL
240118,165543,34,6/8/2023,27479384,1190550,851298,339252,26288834,N,NULL,10,7/11/2020,NULL
240119,165543,35,6/9/2023,26617444,1190550,861940,328610,25426894,N,NULL,10,7/11/2020,NULL
240120,165543,36,6/10/2023,25744730,1190550,872714,317836,24554180,N,NULL,10,7/11/2020,NULL
240121,165543,37,6/11/2023,24861107,1190550,883623,306927,23670557,N,NULL,10,7/11/2020,NULL
240122,165543,38,6/12/2023,23966439,1190550,894668,295882,22775889,N,NULL,10,7/11/2020,NULL
240123,165543,39,6/1/2024,23060588,1190550,905851,284699,21870038,N,NULL,10,7/11/2020,NULL
240124,165543,40,6/2/2024,22143414,1190550,917174,273375,20952864,N,NULL,10,7/11/2020,NULL
240125,165543,41,6/3/2024,21214775,1190550,928639,261911,20024225,N,NULL,10,7/11/2020,NULL
240126,165543,42,6/4/2024,20274528,1190550,940247,250303,19083978,N,NULL,10,7/11/2020,NULL
240127,165543,43,6/5/2024,19322528,1190550,952000,238550,18131978,N,NULL,10,7/11/2020,NULL
240128,165543,44,6/6/2024,18358628,1190550,963900,226650,17168078,N,NULL,10,7/11/2020,NULL
240129,165543,45,6/7/2024,17382679,1190550,975949,214601,16192129,N,NULL,10,7/11/2020,NULL
240130,165543,46,6/8/2024,16394531,1190550,988148,202402,15203981,N,NULL,10,7/11/2020,NULL
240131,165543,47,6/9/2024,15394031,1190550,1000500,190050,14203481,N,NULL,10,7/11/2020,NULL
240132,165543,48,6/10/2024,14381025,1190550,1013006,177544,13190475,N,NULL,10,7/11/2020,NULL
240133,165543,49,6/11/2024,13355356,1190550,1025669,164881,12164806,N,NULL,10,7/11/2020,NULL
240134,165543,50,6/12/2024,12316866,1190550,1038490,152060,11126316,N,NULL,10,7/11/2020,NULL
240135,165543,51,6/1/2025,11265395,1190550,1051471,139079,10074845,N,NULL,10,7/11/2020,NULL
240136,165543,52,6/2/2025,10200781,1190550,1064614,125936,9010231,N,NULL,10,7/11/2020,NULL
240137,165543,53,6/3/2025,9122859,1190550,1077922,112628,7932309,N,NULL,10,7/11/2020,NULL
240138,165543,54,6/4/2025,8031463,1190550,1091396,99154,6840913,N,NULL,10,7/11/2020,NULL
240139,165543,55,6/5/2025,6926424,1190550,1105039,85511,5735874,N,NULL,10,7/11/2020,NULL
240140,165543,56,6/6/2025,5807572,1190550,1118852,71698,4617022,N,NULL,10,7/11/2020,NULL
240141,165543,57,6/7/2025,4674735,1190550,1132837,57713,3484185,N,NULL,10,7/11/2020,NULL
240142,165543,58,6/8/2025,3527737,1190550,1146998,43552,2337187,N,NULL,10,7/11/2020,NULL
240143,165543,59,6/9/2025,2366402,1190550,1161335,29215,1175852,N,NULL,10,7/11/2020,NULL
240144,165543,60,6/10/2025,1190550,1190550,1175852,14698,0,N,NULL,10,7/11/2020,NULL
249853,175526,1,9/12/2020,10125000,484866,359866,125000,9640134,Y,9/12/2020,9,10/11/2020,276036
249854,175526,2,9/1/2021,9760635,484866,364365,120502,9275769,N,NULL,9,10/11/2020,NULL
249855,175526,3,9/2/2021,9391716,484866,368919,115947,8906850,N,NULL,9,10/11/2020,NULL
249856,175526,4,9/3/2021,9018185,484866,373531,111336,8533319,N,NULL,9,10/11/2020,NULL
249857,175526,5,9/4/2021,8639985,484866,378200,106666,8155119,N,NULL,9,10/11/2020,NULL
249858,175526,6,9/5/2021,8257058,484866,382927,101939,7772192,N,NULL,9,10/11/2020,NULL
249859,175526,7,9/6/2021,7869344,484866,387714,97152,7384478,N,NULL,9,10/11/2020,NULL
249860,175526,8,9/7/2021,7476783,484866,392561,92306,6991917,N,NULL,9,10/11/2020,NULL
249861,175526,9,9/8/2021,7079315,484866,397468,87399,6594449,N,NULL,9,10/11/2020,NULL
249862,175526,10,9/9/2021,6676879,484866,402436,82431,6192013,N,NULL,9,10/11/2020,NULL
249863,175526,11,9/10/2021,6269413,484866,407466,77400,5784547,N,NULL,9,10/11/2020,NULL
249864,175526,12,9/11/2021,5856853,484866,412560,72307,5371987,N,NULL,9,10/11/2020,NULL
249865,175526,13,9/12/2021,5439136,484866,417717,67150,4954270,N,NULL,9,10/11/2020,NULL
249866,175526,14,9/1/2022,5016198,484866,422938,61928,4531332,N,NULL,9,10/11/2020,NULL
249867,175526,15,9/2/2022,4587973,484866,428225,56642,4103107,N,NULL,9,10/11/2020,NULL
249868,175526,16,9/3/2022,4154395,484866,433578,51289,3669529,N,NULL,9,10/11/2020,NULL
249869,175526,17,9/4/2022,3715398,484866,438997,45869,3230532,N,NULL,9,10/11/2020,NULL
249870,175526,18,9/5/2022,3270913,484866,444485,40382,2786047,N,NULL,9,10/11/2020,NULL
249871,175526,19,9/6/2022,2820872,484866,450041,34826,2336006,N,NULL,9,10/11/2020,NULL
249872,175526,20,9/7/2022,2365206,484866,455666,29200,1880340,N,NULL,9,10/11/2020,NULL
249873,175526,21,9/8/2022,1903844,484866,461362,23504,1418978,N,NULL,9,10/11/2020,NULL
249874,175526,22,9/9/2022,1436715,484866,467129,17737,951849,N,NULL,9,10/11/2020,NULL
249875,175526,23,9/10/2022,963747,484866,472968,11898,478881,N,NULL,9,10/11/2020,NULL
249876,175526,24,9/11/2022,484867,484866,478881,5986,0,N,NULL,9,10/11/2020,NULL
249877,175527,1,9/12/2020,5062500,1289305,1226805,62500,3773195,Y,9/12/2020,9,10/11/2020,276035
249878,175527,2,9/1/2021,3820360,1289305,1242140,47165,2531055,N,NULL,9,10/11/2020,NULL
249879,175527,3,9/2/2021,2562693,1289305,1257667,31638,1273388,N,NULL,9,10/11/2020,NULL
249880,175527,4,9/3/2021,1289305,1289305,1273388,15917,0,N,NULL,9,10/11/2020,NULL
249881,175528,1,9/12/2020,3037500,622686,585186,37500,2414814,Y,9/12/2020,9,10/11/2020,276034
249882,175528,2,9/1/2021,2444999,622686,592501,30185,1822313,N,NULL,9,10/11/2020,NULL
249883,175528,3,9/2/2021,1845092,622686,599907,22779,1222406,N,NULL,9,10/11/2020,NULL
249884,175528,4,9/3/2021,1237686,622686,607406,15280,615000,N,NULL,9,10/11/2020,NULL
249885,175528,5,9/4/2021,622687,622686,615000,7687,0,N,NULL,9,10/11/2020,NULL
249886,175529,1,9/12/2020,29362500,1406113,1043613,362500,27956387,Y,9/12/2020,9,10/11/2020,276033
249887,175529,2,9/1/2021,28305842,1406113,1056658,349455,26899729,N,NULL,9,10/11/2020,NULL
249888,175529,3,9/2/2021,27235976,1406113,1069866,336247,25829863,N,NULL,9,10/11/2020,NULL
249889,175529,4,9/3/2021,26152736,1406113,1083240,322873,24746623,N,NULL,9,10/11/2020,NULL
249890,175529,5,9/4/2021,25055956,1406113,1096780,309333,23649843,N,NULL,9,10/11/2020,NULL
249891,175529,6,9/5/2021,23945466,1406113,1110490,295623,22539353,N,NULL,9,10/11/2020,NULL
249892,175529,7,9/6/2021,22821095,1406113,1124371,281742,21414982,N,NULL,9,10/11/2020,NULL
249893,175529,8,9/7/2021,21682669,1406113,1138426,267687,20276556,N,NULL,9,10/11/2020,NULL
249894,175529,9,9/8/2021,20530013,1406113,1152656,253457,19123900,N,NULL,9,10/11/2020,NULL
249895,175529,10,9/9/2021,19362949,1406113,1167064,239049,17956836,N,NULL,9,10/11/2020,NULL
249896,175529,11,9/10/2021,18181297,1406113,1181652,224460,16775184,N,NULL,9,10/11/2020,NULL
249897,175529,12,9/11/2021,16984874,1406113,1196423,209690,15578761,N,NULL,9,10/11/2020,NULL
249898,175529,13,9/12/2021,15773496,1406113,1211378,194735,14367383,N,NULL,9,10/11/2020,NULL
249899,175529,14,9/1/2022,14546976,1406113,1226520,179592,13140863,N,NULL,9,10/11/2020,NULL
249900,175529,15,9/2/2022,13305124,1406113,1241852,164261,11899011,N,NULL,9,10/11/2020,NULL
249901,175529,16,9/3/2022,12047749,1406113,1257375,148738,10641636,N,NULL,9,10/11/2020,NULL
249902,175529,17,9/4/2022,10774657,1406113,1273092,133020,9368544,N,NULL,9,10/11/2020,NULL
249903,175529,18,9/5/2022,9485651,1406113,1289006,117107,8079538,N,NULL,9,10/11/2020,NULL
249904,175529,19,9/6/2022,8180532,1406113,1305119,100994,6774419,N,NULL,9,10/11/2020,NULL
249905,175529,20,9/7/2022,6859099,1406113,1321433,84680,5452986,N,NULL,9,10/11/2020,NULL
249906,175529,21,9/8/2022,5521149,1406113,1337950,68162,4115036,N,NULL,9,10/11/2020,NULL
249907,175529,22,9/9/2022,4166474,1406113,1354675,51438,2760361,N,NULL,9,10/11/2020,NULL
249908,175529,23,9/10/2022,2794866,1406113,1371608,34505,1388753,N,NULL,9,10/11/2020,NULL
249909,175529,24,9/11/2022,1406113,1406113,1388753,17359,0,N,NULL,9,10/11/2020,NULL
249910,175530,1,9/12/2020,4050000,1031444,981444,50000,3018556,Y,9/12/2020,9,10/11/2020,276032
249911,175530,2,9/1/2021,3056288,1031444,993712,37732,2024844,N,NULL,9,10/11/2020,NULL
249912,175530,3,9/2/2021,2050154,1031444,1006134,25311,1018710,N,NULL,9,10/11/2020,NULL
249913,175530,4,9/3/2021,1031444,1031444,1018710,12734,0,N,NULL,9,10/11/2020,NULL
249914,175531,1,9/12/2020,3543009,902325,858584,43741,2640684,Y,9/12/2020,9,10/11/2020,276031
249915,175531,2,9/1/2021,2673693,902325,869316,33009,1771368,N,NULL,9,10/11/2020,NULL
249916,175531,3,9/2/2021,1793510,902325,880183,22142,891185,N,NULL,9,10/11/2020,NULL
249917,175531,4,9/3/2021,902325,902325,891185,11140,0,N,NULL,9,10/11/2020,NULL
249918,175532,1,11/12/2020,101160715,3463476,2214578,1248898,97697239,Y,11/12/2020,9,16/11/2020,276158
249919,175532,2,11/1/2021,98918455,3463476,2242260,1221215,95454979,N,NULL,9,16/11/2020,NULL
249920,175532,3,11/2/2021,96648166,3463476,2270289,1193187,93184690,N,NULL,9,16/11/2020,NULL
249921,175532,4,11/3/2021,94349499,3463476,2298667,1164809,90886023,N,NULL,9,16/11/2020,NULL
249922,175532,5,11/4/2021,92022098,3463476,2327401,1136075,88558622,N,NULL,9,16/11/2020,NULL
249923,175532,6,11/5/2021,89665605,3463476,2356493,1106983,86202129,N,NULL,9,16/11/2020,NULL
249924,175532,7,11/6/2021,87279656,3463476,2385949,1077527,83816180,N,NULL,9,16/11/2020,NULL
249925,175532,8,11/7/2021,84863882,3463476,2415774,1047702,81400406,N,NULL,9,16/11/2020,NULL
249926,175532,9,11/8/2021,82417911,3463476,2445971,1017505,78954435,N,NULL,9,16/11/2020,NULL
249927,175532,10,11/9/2021,79941365,3463476,2476546,986930,76477889,N,NULL,9,16/11/2020,NULL
249928,175532,11,11/10/2021,77433863,3463476,2507502,955974,73970387,N,NULL,9,16/11/2020,NULL
249929,175532,12,11/11/2021,74895017,3463476,2538846,924630,71431541,N,NULL,9,16/11/2020,NULL
249930,175532,13,11/12/2021,72324435,3463476,2570582,892894,68860959,N,NULL,9,16/11/2020,NULL
249931,175532,14,11/1/2022,69721721,3463476,2602714,860762,66258245,N,NULL,9,16/11/2020,NULL
249932,175532,15,11/2/2022,67086473,3463476,2635248,828228,63622997,N,NULL,9,16/11/2020,NULL
249933,175532,16,11/3/2022,64418285,3463476,2668188,795287,60954809,N,NULL,9,16/11/2020,NULL
249934,175532,17,11/4/2022,61716744,3463476,2701541,761935,58253268,N,NULL,9,16/11/2020,NULL
249935,175532,18,11/5/2022,58981434,3463476,2735310,728166,55517958,N,NULL,9,16/11/2020,NULL
249936,175532,19,11/6/2022,56211933,3463476,2769501,693974,52748457,N,NULL,9,16/11/2020,NULL
249937,175532,20,11/7/2022,53407813,3463476,2804120,659356,49944337,N,NULL,9,16/11/2020,NULL
249938,175532,21,11/8/2022,50568641,3463476,2839172,624304,47105165,N,NULL,9,16/11/2020,NULL
249939,175532,22,11/9/2022,47693980,3463476,2874661,588815,44230504,N,NULL,9,16/11/2020,NULL
249940,175532,23,11/10/2022,44783385,3463476,2910595,552881,41319909,N,NULL,9,16/11/2020,NULL
249941,175532,24,11/11/2022,41836408,3463476,2946977,516499,38372932,N,NULL,9,16/11/2020,NULL
249942,175532,25,11/12/2022,38852594,3463476,2983814,479662,35389118,N,NULL,9,16/11/2020,NULL
249943,175532,26,11/1/2023,35831482,3463476,3021112,442364,32368006,N,NULL,9,16/11/2020,NULL
249944,175532,27,11/2/2023,32772606,3463476,3058876,404600,29309130,N,NULL,9,16/11/2020,NULL
249945,175532,28,11/3/2023,29675494,3463476,3097112,366364,26212018,N,NULL,9,16/11/2020,NULL
249946,175532,29,11/4/2023,26539668,3463476,3135826,327650,23076192,N,NULL,9,16/11/2020,NULL
249947,175532,30,11/5/2023,23364644,3463476,3175024,288452,19901168,N,NULL,9,16/11/2020,NULL
249948,175532,31,11/6/2023,20149933,3463476,3214711,248765,16686457,N,NULL,9,16/11/2020,NULL
249949,175532,32,11/7/2023,16895038,3463476,3254895,208581,13431562,N,NULL,9,16/11/2020,NULL
249950,175532,33,11/8/2023,13599457,3463476,3295581,167895,10135981,N,NULL,9,16/11/2020,NULL
249951,175532,34,11/9/2023,10262681,3463476,3336776,126700,6799205,N,NULL,9,16/11/2020,NULL
249952,175532,35,11/10/2023,6884195,3463476,3378486,84990,3420719,N,NULL,9,16/11/2020,NULL
249953,175532,36,11/11/2023,3463478,3463476,3420719,42759,0,N,NULL,9,16/11/2020,NULL
249954,175533,1,12/12/2020,4568852,1163584,1107179,56406,3405268,Y,12/12/2020,9,16/11/2020,276204
249955,175533,2,12/1/2021,3447834,1163584,1121018,42566,2284250,N,NULL,9,16/11/2020,NULL
249956,175533,3,12/2/2021,2312803,1163584,1135031,28553,1149219,N,NULL,9,16/11/2020,NULL
249957,175533,4,12/3/2021,1163584,1163584,1149219,14365,0,N,NULL,9,16/11/2020,NULL
249958,175534,1,12/12/2020,1012500,257861,245361,12500,754639,Y,12/12/2020,9,16/11/2020,276203
249959,175534,2,12/1/2021,764072,257861,248428,9433,506211,N,NULL,9,16/11/2020,NULL
249960,175534,3,12/2/2021,512539,257861,251533,6328,254678,N,NULL,9,16/11/2020,NULL
249961,175534,4,12/3/2021,257861,257861,254678,3183,0,N,NULL,9,16/11/2020,NULL
249962,175535,1,13/12/2020,716313,123124,114280,8843,593189,Y,13/12/2020,9,16/11/2020,276216
249963,175535,2,13/01/2021,600604,123124,115709,7415,477480,R,NULL,9,16/11/2020,NULL
249964,175535,3,13/02/2021,483449,123124,117155,5969,360325,R,NULL,9,16/11/2020,NULL
249965,175535,4,13/03/2021,364830,123124,118619,4504,241706,R,NULL,9,16/11/2020,NULL
249966,175535,5,13/04/2021,244728,123124,120102,3021,121604,R,NULL,9,16/11/2020,NULL
249967,175535,6,13/05/2021,123125,123124,121604,1520,0,R,NULL,9,16/11/2020,NULL
249968,175536,1,13/12/2020,2025000,180517,155517,25000,1844483,Y,13/12/2020,9,16/11/2020,276215
249969,175536,2,13/01/2021,1867539,180517,157461,23056,1687022,N,NULL,9,16/11/2020,NULL
249970,175536,3,13/02/2021,1708110,180517,159429,21088,1527593,N,NULL,9,16/11/2020,NULL
249971,175536,4,13/03/2021,1546688,180517,161422,19095,1366171,N,NULL,9,16/11/2020,NULL
249972,175536,5,13/04/2021,1383249,180517,163439,17077,1202732,N,NULL,9,16/11/2020,NULL
249973,175536,6,13/05/2021,1217767,180517,165482,15034,1037250,N,NULL,9,16/11/2020,NULL
249974,175536,7,13/06/2021,1050216,180517,167551,12966,869699,N,NULL,9,16/11/2020,NULL
249975,175536,8,13/07/2021,880571,180517,169645,10871,700054,N,NULL,9,16/11/2020,NULL
249976,175536,9,13/08/2021,708805,180517,171766,8751,528288,N,NULL,9,16/11/2020,NULL
249977,175536,10,13/09/2021,534892,180517,173913,6604,354375,N,NULL,9,16/11/2020,NULL
249978,175536,11,13/10/2021,358805,180517,176087,4430,178288,N,NULL,9,16/11/2020,NULL
249979,175536,12,13/11/2021,180517,180517,178288,2229,0,N,NULL,9,16/11/2020,NULL
249980,175537,1,16/12/2020,8100000,297343,197343,100000,7802657,Y,16/12/2020,9,16/11/2020,276349
249981,175537,2,16/01/2021,7900190,297343,199810,97533,7602847,N,NULL,9,16/11/2020,NULL
249982,175537,3,16/02/2021,7697883,297343,202307,95036,7400540,N,NULL,9,16/11/2020,NULL
249983,175537,4,16/03/2021,7493047,297343,204836,92507,7195704,N,NULL,9,16/11/2020,NULL
249984,175537,5,16/04/2021,7285650,297343,207397,89946,6988307,N,NULL,9,16/11/2020,NULL
249985,175537,6,16/05/2021,7075661,297343,209989,87354,6778318,N,NULL,9,16/11/2020,NULL
249986,175537,7,16/06/2021,6863047,297343,212614,84729,6565704,N,NULL,9,16/11/2020,NULL
249987,175537,8,16/07/2021,6647775,297343,215272,82071,6350432,N,NULL,9,16/11/2020,NULL
249988,175537,9,16/08/2021,6429812,297343,217963,79380,6132469,N,NULL,9,16/11/2020,NULL
249989,175537,10,16/09/2021,6209125,297343,220687,76656,5911782,N,NULL,9,16/11/2020,NULL
249990,175537,11,16/10/2021,5985679,297343,223446,73897,5688336,N,NULL,9,16/11/2020,NULL
249991,175537,12,16/11/2021,5759440,297343,226239,71104,5462097,N,NULL,9,16/11/2020,NULL
249992,175537,13,16/12/2021,5530373,297343,229067,68276,5233030,N,NULL,9,16/11/2020,NULL
249993,175537,14,16/01/2022,5298443,297343,231930,65413,5001100,N,NULL,9,16/11/2020,NULL
249994,175537,15,16/02/2022,5063614,297343,234829,62514,4766271,N,NULL,9,16/11/2020,NULL
249995,175537,16,16/03/2022,4825849,297343,237765,59578,4528506,N,NULL,9,16/11/2020,NULL
249996,175537,17,16/04/2022,4585112,297343,240737,56606,4287769,N,NULL,9,16/11/2020,NULL
249997,175537,18,16/05/2022,4341366,297343,243746,53597,4044023,N,NULL,9,16/11/2020,NULL
249998,175537,19,16/06/2022,4094573,297343,246793,50550,3797230,N,NULL,9,16/11/2020,NULL
249999,175537,20,16/07/2022,3844695,297343,249878,47465,3547352,N,NULL,9,16/11/2020,NULL
250000,175537,21,16/08/2022,3591694,297343,253001,44342,3294351,N,NULL,9,16/11/2020,NULL
250001,175537,22,16/09/2022,3335531,297343,256163,41179,3038188,N,NULL,9,16/11/2020,NULL
250002,175537,23,16/10/2022,3076165,297343,259366,37977,2778822,N,NULL,9,16/11/2020,NULL
250003,175537,24,16/11/2022,2813557,297343,262608,34735,2516214,N,NULL,9,16/11/2020,NULL
250004,175537,25,16/12/2022,2547667,297343,265890,31453,2250324,N,NULL,9,16/11/2020,NULL
250005,175537,26,16/01/2023,2278453,297343,269214,28129,1981110,N,NULL,9,16/11/2020,NULL
250006,175537,27,16/02/2023,2005874,297343,272579,24764,1708531,N,NULL,9,16/11/2020,NULL
250007,175537,28,16/03/2023,1729888,297343,275986,21357,1432545,N,NULL,9,16/11/2020,NULL
250008,175537,29,16/04/2023,1450452,297343,279436,17907,1153109,N,NULL,9,16/11/2020,NULL
250009,175537,30,16/05/2023,1167523,297343,282929,14414,870180,N,NULL,9,16/11/2020,NULL
250010,175537,31,16/06/2023,881057,297343,286466,10877,583714,N,NULL,9,16/11/2020,NULL
250011,175537,32,16/07/2023,591011,297343,290046,7296,293668,N,NULL,9,16/11/2020,NULL
250012,175537,33,16/08/2023,297339,297343,293668,3671,0,N,NULL,9,16/11/2020,NULL
250013,175538,1,16/12/2020,10115051,1068979,944102,124877,9046072,Y,16/12/2020,9,16/11/2020,276348
250014,175538,2,16/01/2021,9159148,1068979,955903,113076,8090169,N,NULL,9,16/11/2020,NULL
250015,175538,3,16/02/2021,8191296,1068979,967852,101127,7122317,N,NULL,9,16/11/2020,NULL
250016,175538,4,16/03/2021,7211346,1068979,979950,89029,6142367,N,NULL,9,16/11/2020,NULL
250017,175538,5,16/04/2021,6219146,1068979,992200,76780,5150167,N,NULL,9,16/11/2020,NULL
250018,175538,6,16/05/2021,5214544,1068979,1004602,64377,4145565,N,NULL,9,16/11/2020,NULL
250019,175538,7,16/06/2021,4197384,1068979,1017160,51820,3128405,N,NULL,9,16/11/2020,NULL
250020,175538,8,16/07/2021,3167510,1068979,1029874,39105,2098531,N,NULL,9,16/11/2020,NULL
250021,175538,9,16/08/2021,2124762,1068979,1042748,26232,1055783,N,NULL,9,16/11/2020,NULL
250022,175538,10,16/09/2021,1068980,1068979,1055783,13197,0,N,NULL,9,16/11/2020,NULL
250023,175539,1,17/12/2020,4050000,1031444,981444,50000,3018556,Y,17/12/2020,9,18/11/2020,276473
250024,175539,2,17/01/2021,3056288,1031444,993712,37732,2024844,N,NULL,9,18/11/2020,NULL
250025,175539,3,17/02/2021,2050154,1031444,1006134,25311,1018710,N,NULL,9,18/11/2020,NULL
250026,175539,4,17/03/2021,1031444,1031444,1018710,12734,0,N,NULL,9,18/11/2020,NULL
250027,175540,1,18/12/2020,1521250,514233,492983,21250,1007017,Y,18/12/2020,9,18/11/2020,276516
250028,175540,2,18/01/2021,1021283,514233,499967,14266,507050,N,NULL,9,18/11/2020,NULL
250029,175540,3,18/02/2021,514233,514233,507050,7183,0,N,NULL,9,18/11/2020,NULL
250030,175541,1,18/12/2020,506250,103781,97531,6250,402469,Y,18/12/2020,9,18/11/2020,276515
250031,175541,2,18/01/2021,407500,103781,98750,5031,303719,N,NULL,9,18/11/2020,NULL
250032,175541,3,18/02/2021,307515,103781,99985,3796,203734,N,NULL,9,18/11/2020,NULL
250033,175541,4,18/03/2021,206281,103781,101234,2547,102500,N,NULL,9,18/11/2020,NULL
250034,175541,5,18/04/2021,103781,103781,102500,1281,0,N,NULL,9,18/11/2020,NULL
250035,175542,1,18/12/2020,2025000,348068,323068,25000,1676932,Y,18/12/2020,9,18/11/2020,276514
250036,175542,2,18/01/2021,1697894,348068,327106,20962,1349826,N,NULL,9,18/11/2020,NULL
250037,175542,3,18/02/2021,1366699,348068,331195,16873,1018631,N,NULL,9,18/11/2020,NULL
250038,175542,4,18/03/2021,1031364,348068,335335,12733,683296,N,NULL,9,18/11/2020,NULL
250039,175542,5,18/04/2021,691838,348068,339526,8541,343770,N,NULL,9,18/11/2020,NULL
250040,175542,6,18/05/2021,348068,348068,343770,4297,0,N,NULL,9,18/11/2020,NULL
250041,175543,1,20/12/2020,1115583,377104,361521,15583,738479,Y,20/12/2020,9,23/11/2020,276566
250042,175543,2,20/01/2021,748941,377104,366642,10462,371837,N,NULL,9,23/11/2020,NULL
250043,175543,3,20/02/2021,377104,377104,371837,5268,0,N,NULL,9,23/11/2020,NULL
250044,175544,1,20/12/2020,2327582,592783,564047,28736,1734799,Y,20/12/2020,9,23/11/2020,276565
250045,175544,2,20/01/2021,1756484,592783,571098,21685,1163701,N,NULL,9,23/11/2020,NULL
250046,175544,3,20/02/2021,1178247,592783,578237,14546,585464,N,NULL,9,23/11/2020,NULL
250047,175544,4,20/03/2021,592783,592783,585464,7318,0,N,NULL,9,23/11/2020,NULL
250048,175545,1,20/12/2020,9030338,1552182,1440696,111486,7478156,Y,20/12/2020,9,23/11/2020,276564
250049,175545,2,20/01/2021,7571633,1552182,1458705,93477,6019451,N,NULL,9,23/11/2020,NULL
250050,175545,3,20/02/2021,6094694,1552182,1476939,75243,4542512,N,NULL,9,23/11/2020,NULL
250051,175545,4,20/03/2021,4599294,1552182,1495400,56781,3047112,N,NULL,9,23/11/2020,NULL
250052,175545,5,20/04/2021,3085201,1552182,1514093,38089,1533019,N,NULL,9,23/11/2020,NULL
250053,175545,6,20/05/2021,1552182,1552182,1533019,19163,0,N,NULL,9,23/11/2020,NULL
250054,175546,1,20/12/2020,10125000,5093944,4968944,125000,5031056,Y,20/12/2020,9,23/11/2020,276563
250055,175546,2,20/01/2021,5093944,5093944,5031056,62888,0,N,NULL,9,23/11/2020,NULL
250056,175547,1,20/12/2020,5062500,1289305,1226805,62500,3773195,Y,20/12/2020,9,23/11/2020,276562
250057,175547,2,20/01/2021,3820360,1289305,1242140,47165,2531055,N,NULL,9,23/11/2020,NULL
250058,175547,3,20/02/2021,2562693,1289305,1257667,31638,1273388,N,NULL,9,23/11/2020,NULL
250059,175547,4,20/03/2021,1289305,1289305,1273388,15917,0,N,NULL,9,23/11/2020,NULL
250060,175548,1,20/12/2020,9947017,886717,763914,122803,9060300,Y,20/12/2020,9,23/11/2020,276561
250061,175548,2,20/01/2021,9173554,886717,773463,113254,8286837,N,NULL,9,23/11/2020,NULL
250062,175548,3,20/02/2021,8390422,886717,783132,103585,7503705,N,NULL,9,23/11/2020,NULL
250063,175548,4,20/03/2021,7597501,886717,792921,93796,6710784,N,NULL,9,23/11/2020,NULL
250064,175548,5,20/04/2021,6794669,886717,802832,83885,5907952,N,NULL,9,23/11/2020,NULL
250065,175548,6,20/05/2021,5981801,886717,812868,73849,5095084,N,NULL,9,23/11/2020,NULL
250066,175548,7,20/06/2021,5158773,886717,823028,63689,4272056,N,NULL,9,23/11/2020,NULL
250067,175548,8,20/07/2021,4325457,886717,833316,53401,3438740,N,NULL,9,23/11/2020,NULL
250068,175548,9,20/08/2021,3481724,886717,843733,42984,2595007,N,NULL,9,23/11/2020,NULL
250069,175548,10,20/09/2021,2627445,886717,854279,32438,1740728,N,NULL,9,23/11/2020,NULL
250070,175548,11,20/10/2021,1762487,886717,864958,21759,875770,N,NULL,9,23/11/2020,NULL
250071,175548,12,20/11/2021,886717,886717,875770,10947,0,N,NULL,9,23/11/2020,NULL
250072,175549,1,20/12/2020,10125000,1070031,945031,125000,9054969,Y,20/12/2020,9,23/11/2020,276560
250073,175549,2,20/01/2021,9168156,1070031,956844,113187,8098125,N,NULL,9,23/11/2020,NULL
250074,175549,3,20/02/2021,8199352,1070031,968804,101227,7129321,N,NULL,9,23/11/2020,NULL
250075,175549,4,20/03/2021,7218438,1070031,980914,89117,6148407,N,NULL,9,23/11/2020,NULL
250076,175549,5,20/04/2021,6225262,1070031,993176,76855,5155231,N,NULL,9,23/11/2020,NULL
250077,175549,6,20/05/2021,5219672,1070031,1005590,64440,4149641,N,NULL,9,23/11/2020,NULL
250078,175549,7,20/06/2021,4201512,1070031,1018160,51871,3131481,N,NULL,9,23/11/2020,NULL
250079,175549,8,20/07/2021,3170625,1070031,1030887,39144,2100594,N,NULL,9,23/11/2020,NULL
250080,175549,9,20/08/2021,2126852,1070031,1043773,26257,1056821,N,NULL,9,23/11/2020,NULL
250081,175549,10,20/09/2021,1070032,1070031,1056821,13210,0,N,NULL,9,23/11/2020,NULL
250082,175550,1,23/12/2020,8606250,1123132,1016882,106250,7483118,N,NULL,9,23/11/2020,NULL
250083,175550,2,23/01/2021,7576657,1123132,1029593,93539,6453525,N,NULL,9,23/11/2020,NULL
250084,175550,3,23/02/2021,6534194,1123132,1042463,80669,5411062,N,NULL,9,23/11/2020,NULL
250085,175550,4,23/03/2021,5478701,1123132,1055493,67638,4355569,N,NULL,9,23/11/2020,NULL
250086,175550,5,23/04/2021,4410014,1123132,1068687,54445,3286882,N,NULL,9,23/11/2020,NULL
250087,175550,6,23/05/2021,3327968,1123132,1082046,41086,2204836,N,NULL,9,23/11/2020,NULL
250088,175550,7,23/06/2021,2232397,1123132,1095571,27560,1109265,N,NULL,9,23/11/2020,NULL
250089,175550,8,23/07/2021,1123131,1123132,1109265,13866,0,N,NULL,9,23/11/2020,NULL
250090,175551,1,23/12/2020,3248345,558343,518240,40103,2690002,N,NULL,9,24/11/2020,NULL
250091,175551,2,23/01/2021,2723627,558343,524718,33625,2165284,N,NULL,9,24/11/2020,NULL
250092,175551,3,23/02/2021,2192350,558343,531277,27066,1634007,N,NULL,9,24/11/2020,NULL
250093,175551,4,23/03/2021,1654433,558343,537917,20425,1096090,N,NULL,9,24/11/2020,NULL
250094,175551,5,23/04/2021,1109792,558343,544641,13701,551449,N,NULL,9,24/11/2020,NULL
250095,175551,6,23/05/2021,558343,558343,551449,6893,0,N,NULL,9,24/11/2020,NULL
250096,175552,1,23/12/2020,1014167,342822,328655,14167,671345,N,NULL,9,24/11/2020,NULL
250097,175552,2,23/01/2021,680856,342822,333311,9511,338034,N,NULL,9,24/11/2020,NULL
250098,175552,3,23/02/2021,342823,342822,338034,4789,0,N,NULL,9,24/11/2020,NULL
250099,175553,1,23/12/2020,2285920,392916,364695,28221,1893004,N,NULL,9,24/11/2020,NULL
250100,175553,2,23/01/2021,1916667,392916,369253,23663,1523751,N,NULL,9,24/11/2020,NULL
250101,175553,3,23/02/2021,1542798,392916,373869,19047,1149882,N,NULL,9,24/11/2020,NULL
250102,175553,4,23/03/2021,1164256,392916,378542,14374,771340,N,NULL,9,24/11/2020,NULL
250103,175553,5,23/04/2021,780982,392916,383274,9642,388066,N,NULL,9,24/11/2020,NULL
250104,175553,6,23/05/2021,392917,392916,388066,4851,0,N,NULL,9,24/11/2020,NULL
250105,165470,1,6/1/2021,25156095,591073,280504,310569,24565022,N,NULL,9,24/11/2020,NULL
250106,165470,2,6/2/2021,24872084,591073,284011,307063,24281011,N,NULL,9,24/11/2020,NULL
250107,165470,3,6/3/2021,24584523,591073,287561,303513,23993450,N,NULL,9,24/11/2020,NULL
250108,165470,4,6/4/2021,24293368,591073,291155,299918,23702295,N,NULL,9,24/11/2020,NULL
250109,165470,5,6/5/2021,23998573,591073,294795,296279,23407500,N,NULL,9,24/11/2020,NULL
250110,165470,6,6/6/2021,23700093,591073,298480,292594,23109020,N,NULL,9,24/11/2020,NULL
250111,165470,7,6/7/2021,23397882,591073,302211,288863,22806809,N,NULL,9,24/11/2020,NULL
250112,165470,8,6/8/2021,23091894,591073,305988,285085,22500821,N,NULL,9,24/11/2020,NULL
250113,165470,9,6/9/2021,22782081,591073,309813,281260,22191008,N,NULL,9,24/11/2020,NULL
250114,165470,10,6/10/2021,22468395,591073,313686,277388,21877322,N,NULL,9,24/11/2020,NULL
250115,165470,11,6/11/2021,22150788,591073,317607,273467,21559715,N,NULL,9,24/11/2020,NULL
250116,165470,12,6/12/2021,21829211,591073,321577,269496,21238138,N,NULL,9,24/11/2020,NULL
250117,165470,13,6/1/2022,21503614,591073,325597,265477,20912541,N,NULL,9,24/11/2020,NULL
250118,165470,14,6/2/2022,21173947,591073,329667,261407,20582874,N,NULL,9,24/11/2020,NULL
250119,165470,15,6/3/2022,20840160,591073,333787,257286,20249087,N,NULL,9,24/11/2020,NULL
250120,165470,16,6/4/2022,20502200,591073,337960,253114,19911127,N,NULL,9,24/11/2020,NULL
250121,165470,17,6/5/2022,20160016,591073,342184,248889,19568943,N,NULL,9,24/11/2020,NULL
250122,165470,18,6/6/2022,19813554,591073,346462,244612,19222481,N,NULL,9,24/11/2020,NULL
250123,165470,19,6/7/2022,19462762,591073,350792,240281,18871689,N,NULL,9,24/11/2020,NULL
250124,165470,20,6/8/2022,19107585,591073,355177,235896,18516512,N,NULL,9,24/11/2020,NULL
250125,165470,21,6/9/2022,18747968,591073,359617,231456,18156895,N,NULL,9,24/11/2020,NULL
250126,165470,22,6/10/2022,18383856,591073,364112,226961,17792783,N,NULL,9,24/11/2020,NULL
250127,165470,23,6/11/2022,18015192,591073,368664,222410,17424119,N,NULL,9,24/11/2020,NULL
250128,165470,24,6/12/2022,17641920,591073,373272,217802,17050847,N,NULL,9,24/11/2020,NULL
250129,165470,25,6/1/2023,17263982,591073,377938,213136,16672909,N,NULL,9,24/11/2020,NULL
250130,165470,26,6/2/2023,16881320,591073,382662,208411,16290247,N,NULL,9,24/11/2020,NULL
250131,165470,27,6/3/2023,16493875,591073,387445,203628,15902802,N,NULL,9,24/11/2020,NULL
250132,165470,28,6/4/2023,16101587,591073,392288,198785,15510514,N,NULL,9,24/11/2020,NULL
250133,165470,29,6/5/2023,15704395,591073,397192,193881,15113322,N,NULL,9,24/11/2020,NULL
250134,165470,30,6/6/2023,15302238,591073,402157,188917,14711165,N,NULL,9,24/11/2020,NULL
250135,165470,31,6/7/2023,14895054,591073,407184,183890,14303981,N,NULL,9,24/11/2020,NULL
250136,165470,32,6/8/2023,14482780,591073,412274,178800,13891707,N,NULL,9,24/11/2020,NULL
250137,165470,33,6/9/2023,14065353,591073,417427,173646,13474280,N,NULL,9,24/11/2020,NULL
250138,165470,34,6/10/2023,13642708,591073,422645,168429,13051635,N,NULL,9,24/11/2020,NULL
250139,165470,35,6/11/2023,13214780,591073,427928,163145,12623707,N,NULL,9,24/11/2020,NULL
250140,165470,36,6/12/2023,12781503,591073,433277,157796,12190430,N,NULL,9,24/11/2020,NULL
250141,165470,37,6/1/2024,12342810,591073,438693,152380,11751737,N,NULL,9,24/11/2020,NULL
250142,165470,38,6/2/2024,11898633,591073,444177,146897,11307560,N,NULL,9,24/11/2020,NULL
250143,165470,39,6/3/2024,11448904,591073,449729,141345,10857831,N,NULL,9,24/11/2020,NULL
250144,165470,40,6/4/2024,10993554,591073,455350,135723,10402481,N,NULL,9,24/11/2020,NULL
250145,165470,41,6/5/2024,10532512,591073,461042,130031,9941439,N,NULL,9,24/11/2020,NULL
250146,165470,42,6/6/2024,10065707,591073,466805,124268,9474634,N,NULL,9,24/11/2020,NULL
250147,165470,43,6/7/2024,9593067,591073,472640,118433,9001994,N,NULL,9,24/11/2020,NULL
250148,165470,44,6/8/2024,9114519,591073,478548,112525,8523446,N,NULL,9,24/11/2020,NULL
250149,165470,45,6/9/2024,8629989,591073,484530,106543,8038916,N,NULL,9,24/11/2020,NULL
250150,165470,46,6/10/2024,8139402,591073,490587,100486,7548329,N,NULL,9,24/11/2020,NULL
250151,165470,47,6/11/2024,7642683,591073,496719,94354,7051610,N,NULL,9,24/11/2020,NULL
250152,165470,48,6/12/2024,7139755,591073,502928,88145,6548682,N,NULL,9,24/11/2020,NULL
250153,165470,49,6/1/2025,6630540,591073,509215,81859,6039467,N,NULL,9,24/11/2020,NULL
250154,165470,50,6/2/2025,6114960,591073,515580,75493,5523887,N,NULL,9,24/11/2020,NULL
250155,165470,51,6/3/2025,5592935,591073,522025,69049,5001862,N,NULL,9,24/11/2020,NULL
250156,165470,52,6/4/2025,5064385,591073,528550,62523,4473312,N,NULL,9,24/11/2020,NULL
250157,165470,53,6/5/2025,4529228,591073,535157,55916,3938155,N,NULL,9,24/11/2020,NULL
250158,165470,54,6/6/2025,3987382,591073,541846,49227,3396309,N,NULL,9,24/11/2020,NULL
250159,165470,55,6/7/2025,3438763,591073,548619,42454,2847690,N,NULL,9,24/11/2020,NULL
250160,165470,56,6/8/2025,2883286,591073,555477,35596,2292213,N,NULL,9,24/11/2020,NULL
250161,165470,57,6/9/2025,2320865,591073,562421,28653,1729792,N,NULL,9,24/11/2020,NULL
250162,165470,58,6/10/2025,1751414,591073,569451,21622,1160341,N,NULL,9,24/11/2020,NULL
250163,165470,59,6/11/2025,1174845,591073,576569,14504,583772,N,NULL,9,24/11/2020,NULL
250164,165470,60,6/12/2025,591069,591073,583772,7297,0,N,NULL,9,24/11/2020,NULL
250165,175554,1,23/12/2020,38366847,901476,427811,473665,37465371,N,NULL,9,25/11/2020,NULL
250166,175554,2,23/01/2021,37933688,901476,433159,468317,37032212,N,NULL,9,25/11/2020,NULL
250167,175554,3,23/02/2021,37495114,901476,438574,462903,36593638,N,NULL,9,25/11/2020,NULL
250168,175554,4,23/03/2021,37051058,901476,444056,457420,36149582,N,NULL,9,25/11/2020,NULL
250169,175554,5,23/04/2021,36601452,901476,449606,451870,35699976,N,NULL,9,25/11/2020,NULL
250170,175554,6,23/05/2021,36146226,901476,455226,446250,35244750,N,NULL,9,25/11/2020,NULL
250171,175554,7,23/06/2021,35685309,901476,460917,440559,34783833,N,NULL,9,25/11/2020,NULL
250172,175554,8,23/07/2021,35218631,901476,466678,434798,34317155,N,NULL,9,25/11/2020,NULL
250173,175554,9,23/08/2021,34746119,901476,472512,428964,33844643,N,NULL,9,25/11/2020,NULL
250174,175554,10,23/09/2021,34267701,901476,478418,423058,33366225,N,NULL,9,25/11/2020,NULL
250175,175554,11,23/10/2021,33783303,901476,484398,417078,32881827,N,NULL,9,25/11/2020,NULL
250176,175554,12,23/11/2021,33292850,901476,490453,411023,32391374,N,NULL,9,25/11/2020,NULL
250177,175554,13,23/12/2021,32796266,901476,496584,404892,31894790,N,NULL,9,25/11/2020,NULL
250178,175554,14,23/01/2022,32293475,901476,502791,398685,31391999,N,NULL,9,25/11/2020,NULL
250179,175554,15,23/02/2022,31784399,901476,509076,392400,30882923,N,NULL,9,25/11/2020,NULL
250180,175554,16,23/03/2022,31268959,901476,515440,386037,30367483,N,NULL,9,25/11/2020,NULL
250181,175554,17,23/04/2022,30747076,901476,521883,379594,29845600,N,NULL,9,25/11/2020,NULL
250182,175554,18,23/05/2022,30218670,901476,528406,373070,29317194,N,NULL,9,25/11/2020,NULL
250183,175554,19,23/06/2022,29683659,901476,535011,366465,28782183,N,NULL,9,25/11/2020,NULL
250184,175554,20,23/07/2022,29141960,901476,541699,359777,28240484,N,NULL,9,25/11/2020,NULL
250185,175554,21,23/08/2022,28593490,901476,548470,353006,27692014,N,NULL,9,25/11/2020,NULL
250186,175554,22,23/09/2022,28038164,901476,555326,346150,27136688,N,NULL,9,25/11/2020,NULL
250187,175554,23,23/10/2022,27475896,901476,562268,339209,26574420,N,NULL,9,25/11/2020,NULL
250188,175554,24,23/11/2022,26906600,901476,569296,332180,26005124,N,NULL,9,25/11/2020,NULL
250189,175554,25,23/12/2022,26330188,901476,576412,325064,25428712,N,NULL,9,25/11/2020,NULL
250190,175554,26,23/01/2023,25746571,901476,583617,317859,24845095,N,NULL,9,25/11/2020,NULL
250191,175554,27,23/02/2023,25155659,901476,590912,310564,24254183,N,NULL,9,25/11/2020,NULL
250192,175554,28,23/03/2023,24557360,901476,598299,303177,23655884,N,NULL,9,25/11/2020,NULL
250193,175554,29,23/04/2023,23951582,901476,605778,295699,23050106,N,NULL,9,25/11/2020,NULL
250194,175554,30,23/05/2023,23338232,901476,613350,288126,22436756,N,NULL,9,25/11/2020,NULL
250195,175554,31,23/06/2023,22717215,901476,621017,280459,21815739,N,NULL,9,25/11/2020,NULL
250196,175554,32,23/07/2023,22088436,901476,628779,272697,21186960,N,NULL,9,25/11/2020,NULL
250197,175554,33,23/08/2023,21451797,901476,636639,264837,20550321,N,NULL,9,25/11/2020,NULL
250198,175554,34,23/09/2023,20807200,901476,644597,256879,19905724,N,NULL,9,25/11/2020,NULL
250199,175554,35,23/10/2023,20154545,901476,652655,248822,19253069,N,NULL,9,25/11/2020,NULL
250200,175554,36,23/11/2023,19493732,901476,660813,240663,18592256,N,NULL,9,25/11/2020,NULL
250201,175554,37,23/12/2023,18824659,901476,669073,232403,17923183,N,NULL,9,25/11/2020,NULL
250202,175554,38,23/01/2024,18147223,901476,677436,224040,17245747,N,NULL,9,25/11/2020,NULL
250203,175554,39,23/02/2024,17461319,901476,685904,215572,16559843,N,NULL,9,25/11/2020,NULL
250204,175554,40,23/03/2024,16766841,901476,694478,206998,15865365,N,NULL,9,25/11/2020,NULL
250205,175554,41,23/04/2024,16063682,901476,703159,198317,15162206,N,NULL,9,25/11/2020,NULL
250206,175554,42,23/05/2024,15351733,901476,711949,189528,14450257,N,NULL,9,25/11/2020,NULL
250207,175554,43,23/06/2024,14630885,901476,720848,180628,13729409,N,NULL,9,25/11/2020,NULL
250208,175554,44,23/07/2024,13901026,901476,729859,171618,12999550,N,NULL,9,25/11/2020,NULL
250209,175554,45,23/08/2024,13162044,901476,738982,162494,12260568,N,NULL,9,25/11/2020,NULL
250210,175554,46,23/09/2024,12413825,901476,748219,153257,11512349,N,NULL,9,25/11/2020,NULL
250211,175554,47,23/10/2024,11656253,901476,757572,143904,10754777,N,NULL,9,25/11/2020,NULL
250212,175554,48,23/11/2024,10889212,901476,767041,134435,9987736,N,NULL,9,25/11/2020,NULL
250213,175554,49,23/12/2024,10112583,901476,776629,124847,9211107,N,NULL,9,25/11/2020,NULL
250214,175554,50,23/01/2025,9326246,901476,786337,115139,8424770,N,NULL,9,25/11/2020,NULL
250215,175554,51,23/02/2025,8530079,901476,796167,105310,7628603,N,NULL,9,25/11/2020,NULL
250216,175554,52,23/03/2025,7723960,901476,806119,95358,6822484,N,NULL,9,25/11/2020,NULL
250217,175554,53,23/04/2025,6907765,901476,816195,85281,6006289,N,NULL,9,25/11/2020,NULL
250218,175554,54,23/05/2025,6081367,901476,826398,75079,5179891,N,NULL,9,25/11/2020,NULL
250219,175554,55,23/06/2025,5244639,901476,836728,64749,4343163,N,NULL,9,25/11/2020,NULL
250220,175554,56,23/07/2025,4397452,901476,847187,54290,3495976,N,NULL,9,25/11/2020,NULL
250221,175554,57,23/08/2025,3539676,901476,857776,43700,2638200,N,NULL,9,25/11/2020,NULL
250222,175554,58,23/09/2025,2671177,901476,868499,32978,1769701,N,NULL,9,25/11/2020,NULL
250223,175554,59,23/10/2025,1791822,901476,879355,22121,890346,N,NULL,9,25/11/2020,NULL
250224,175554,60,23/11/2025,901475,901476,890346,11129,0,N,NULL,9,25/11/2020,NULL
250225,175555,1,23/12/2020,110012425,2584877,1226699,1358178,107427548,N,NULL,9,25/11/2020,NULL
250226,175555,2,23/01/2021,108770392,2584877,1242033,1342844,106185515,N,NULL,9,25/11/2020,NULL
250227,175555,3,23/02/2021,107512834,2584877,1257558,1327319,104927957,N,NULL,9,25/11/2020,NULL
250228,175555,4,23/03/2021,106239557,2584877,1273277,1311599,103654680,N,NULL,9,25/11/2020,NULL
250229,175555,5,23/04/2021,104950364,2584877,1289193,1295684,102365487,N,NULL,9,25/11/2020,NULL
250230,175555,6,23/05/2021,103645056,2584877,1305308,1279569,101060179,N,NULL,9,25/11/2020,NULL
250231,175555,7,23/06/2021,102323431,2584877,1321625,1263252,99738554,N,NULL,9,25/11/2020,NULL
250232,175555,8,23/07/2021,100985286,2584877,1338145,1246732,98400409,N,NULL,9,25/11/2020,NULL
250233,175555,9,23/08/2021,99630414,2584877,1354872,1230005,97045537,N,NULL,9,25/11/2020,NULL
250234,175555,10,23/09/2021,98258606,2584877,1371808,1213069,95673729,N,NULL,9,25/11/2020,NULL
250235,175555,11,23/10/2021,96869651,2584877,1388955,1195922,94284774,N,NULL,9,25/11/2020,NULL
250236,175555,12,23/11/2021,95463334,2584877,1406317,1178560,92878457,N,NULL,9,25/11/2020,NULL
250237,175555,13,23/12/2021,94039438,2584877,1423896,1160981,91454561,N,NULL,9,25/11/2020,NULL
250238,175555,14,23/01/2022,92597743,2584877,1441695,1143182,90012866,N,NULL,9,25/11/2020,NULL
250239,175555,15,23/02/2022,91138027,2584877,1459716,1125161,88553150,N,NULL,9,25/11/2020,NULL
250240,175555,16,23/03/2022,89660064,2584877,1477963,1106914,87075187,N,NULL,9,25/11/2020,NULL
250241,175555,17,23/04/2022,88163627,2584877,1496437,1088440,85578750,N,NULL,9,25/11/2020,NULL
250242,175555,18,23/05/2022,86648484,2584877,1515143,1069734,84063607,N,NULL,9,25/11/2020,NULL
250243,175555,19,23/06/2022,85114402,2584877,1534082,1050795,82529525,N,NULL,9,25/11/2020,NULL
250244,175555,20,23/07/2022,83561144,2584877,1553258,1031619,80976267,N,NULL,9,25/11/2020,NULL
250245,175555,21,23/08/2022,81988470,2584877,1572674,1012203,79403593,N,NULL,9,25/11/2020,NULL
250246,175555,22,23/09/2022,80396138,2584877,1592332,992545,77811261,N,NULL,9,25/11/2020,NULL
250247,175555,23,23/10/2022,78783902,2584877,1612236,972641,76199025,N,NULL,9,25/11/2020,NULL
250248,175555,24,23/11/2022,77151513,2584877,1632389,952488,74566636,N,NULL,9,25/11/2020,NULL
250249,175555,25,23/12/2022,75498719,2584877,1652794,932083,72913842,N,NULL,9,25/11/2020,NULL
250250,175555,26,23/01/2023,73825265,2584877,1673454,911423,71240388,N,NULL,9,25/11/2020,NULL
250251,175555,27,23/02/2023,72130893,2584877,1694372,890505,69546016,N,NULL,9,25/11/2020,NULL
250252,175555,28,23/03/2023,70415341,2584877,1715552,869325,67830464,N,NULL,9,25/11/2020,NULL
250253,175555,29,23/04/2023,68678345,2584877,1736996,847881,66093468,N,NULL,9,25/11/2020,NULL
250254,175555,30,23/05/2023,66919636,2584877,1758709,826168,64334759,N,NULL,9,25/11/2020,NULL
250255,175555,31,23/06/2023,65138944,2584877,1780692,804184,62554067,N,NULL,9,25/11/2020,NULL
250256,175555,32,23/07/2023,63335993,2584877,1802951,781926,60751116,N,NULL,9,25/11/2020,NULL
250257,175555,33,23/08/2023,61510505,2584877,1825488,759389,58925628,N,NULL,9,25/11/2020,NULL
250258,175555,34,23/09/2023,59662198,2584877,1848307,736570,57077321,N,NULL,9,25/11/2020,NULL
250259,175555,35,23/10/2023,57790788,2584877,1871410,713467,55205911,N,NULL,9,25/11/2020,NULL
250260,175555,36,23/11/2023,55895985,2584877,1894803,690074,53311108,N,NULL,9,25/11/2020,NULL
250261,175555,37,23/12/2023,53977497,2584877,1918488,666389,51392620,N,NULL,9,25/11/2020,NULL
250262,175555,38,23/01/2024,52035028,2584877,1942469,642408,49450151,N,NULL,9,25/11/2020,NULL
250263,175555,39,23/02/2024,50068278,2584877,1966750,618127,47483401,N,NULL,9,25/11/2020,NULL
250264,175555,40,23/03/2024,48076944,2584877,1991334,593543,45492067,N,NULL,9,25/11/2020,NULL
250265,175555,41,23/04/2024,46060718,2584877,2016226,568651,43475841,N,NULL,9,25/11/2020,NULL
250266,175555,42,23/05/2024,44019289,2584877,2041429,543448,41434412,N,NULL,9,25/11/2020,NULL
250267,175555,43,23/06/2024,41952342,2584877,2066947,517930,39367465,N,NULL,9,25/11/2020,NULL
250268,175555,44,23/07/2024,39859558,2584877,2092784,492093,37274681,N,NULL,9,25/11/2020,NULL
250269,175555,45,23/08/2024,37740615,2584877,2118943,465934,35155738,N,NULL,9,25/11/2020,NULL
250270,175555,46,23/09/2024,35595185,2584877,2145430,439447,33010308,N,NULL,9,25/11/2020,NULL
250271,175555,47,23/10/2024,33422937,2584877,2172248,412629,30838060,N,NULL,9,25/11/2020,NULL
250272,175555,48,23/11/2024,31223536,2584877,2199401,385476,28638659,N,NULL,9,25/11/2020,NULL
250273,175555,49,23/12/2024,28996642,2584877,2226894,357983,26411765,N,NULL,9,25/11/2020,NULL
250274,175555,50,23/01/2025,26741912,2584877,2254730,330147,24157035,N,NULL,9,25/11/2020,NULL
250275,175555,51,23/02/2025,24458998,2584877,2282914,301963,21874121,N,NULL,9,25/11/2020,NULL
250276,175555,52,23/03/2025,22147548,2584877,2311450,273427,19562671,N,NULL,9,25/11/2020,NULL
250277,175555,53,23/04/2025,19807204,2584877,2340344,244533,17222327,N,NULL,9,25/11/2020,NULL
250278,175555,54,23/05/2025,17437606,2584877,2369598,215279,14852729,N,NULL,9,25/11/2020,NULL
250279,175555,55,23/06/2025,15038388,2584877,2399218,185659,12453511,N,NULL,9,25/11/2020,NULL
250280,175555,56,23/07/2025,12609180,2584877,2429208,155669,10024303,N,NULL,9,25/11/2020,NULL
250281,175555,57,23/08/2025,10149607,2584877,2459573,125304,7564730,N,NULL,9,25/11/2020,NULL
250282,175555,58,23/09/2025,7659289,2584877,2490318,94559,5074412,N,NULL,9,25/11/2020,NULL
250283,175555,59,23/10/2025,5137842,2584877,2521447,63430,2552965,N,NULL,9,25/11/2020,NULL
250284,175555,60,23/11/2025,2584877,2584877,2552965,31912,0,N,NULL,9,25/11/2020,NULL
250285,175556,1,23/12/2020,4671168,1189642,1131973,57669,3481526,N,NULL,9,25/11/2020,NULL
250286,175556,2,23/01/2021,3525046,1189642,1146122,43519,2335404,N,NULL,9,25/11/2020,NULL
250287,175556,3,23/02/2021,2364597,1189642,1160449,29193,1174955,N,NULL,9,25/11/2020,NULL
250288,175556,4,23/03/2021,1189642,1189642,1174955,14687,0,N,NULL,9,25/11/2020,NULL
250289,175557,1,23/12/2020,4100515,1044309,993685,50624,3056206,N,NULL,9,25/11/2020,NULL
250290,175557,2,23/01/2021,3094409,1044309,1006106,38203,2050100,N,NULL,9,25/11/2020,NULL
250291,175557,3,23/02/2021,2075726,1044309,1018683,25626,1031417,N,NULL,9,25/11/2020,NULL
250292,175557,4,23/03/2021,1044310,1044309,1031417,12893,0,N,NULL,9,25/11/2020,NULL
250293,175558,1,23/12/2020,49927174,1173100,556715,616385,48754074,N,NULL,9,25/11/2020,NULL
250294,175558,2,23/01/2021,49363500,1173100,563674,609426,48190400,N,NULL,9,25/11/2020,NULL
250295,175558,3,23/02/2021,48792780,1173100,570720,602380,47619680,N,NULL,9,25/11/2020,NULL
250296,175558,4,23/03/2021,48214926,1173100,577854,595246,47041826,N,NULL,9,25/11/2020,NULL
250297,175558,5,23/04/2021,47629849,1173100,585077,588023,46456749,N,NULL,9,25/11/2020,NULL
250298,175558,6,23/05/2021,47037458,1173100,592391,580709,45864358,N,NULL,9,25/11/2020,NULL
250299,175558,7,23/06/2021,46437662,1173100,599796,573304,45264562,N,NULL,9,25/11/2020,NULL
250300,175558,8,23/07/2021,45830369,1173100,607293,565807,44657269,N,NULL,9,25/11/2020,NULL
250301,175558,9,23/08/2021,45215485,1173100,614884,558216,44042385,N,NULL,9,25/11/2020,NULL
250302,175558,10,23/09/2021,44592915,1173100,622570,550530,43419815,N,NULL,9,25/11/2020,NULL
250303,175558,11,23/10/2021,43962562,1173100,630353,542748,42789462,N,NULL,9,25/11/2020,NULL
250304,175558,12,23/11/2021,43324330,1173100,638232,534868,42151230,N,NULL,9,25/11/2020,NULL
250305,175558,13,23/12/2021,42678120,1173100,646210,526890,41505020,N,NULL,9,25/11/2020,NULL
250306,175558,14,23/01/2022,42023833,1173100,654287,518813,40850733,N,NULL,9,25/11/2020,NULL
250307,175558,15,23/02/2022,41361367,1173100,662466,510634,40188267,N,NULL,9,25/11/2020,NULL
250308,175558,16,23/03/2022,40690620,1173100,670747,502353,39517520,N,NULL,9,25/11/2020,NULL
250309,175558,17,23/04/2022,40011489,1173100,679131,493969,38838389,N,NULL,9,25/11/2020,NULL
250310,175558,18,23/05/2022,39323869,1173100,687620,485480,38150769,N,NULL,9,25/11/2020,NULL
250311,175558,19,23/06/2022,38627653,1173100,696216,476885,37454553,N,NULL,9,25/11/2020,NULL
250312,175558,20,23/07/2022,37922735,1173100,704918,468182,36749635,N,NULL,9,25/11/2020,NULL
250313,175558,21,23/08/2022,37209005,1173100,713730,459370,36035905,N,NULL,9,25/11/2020,NULL
250314,175558,22,23/09/2022,36486354,1173100,722651,450449,35313254,N,NULL,9,25/11/2020,NULL
250315,175558,23,23/10/2022,35754669,1173100,731685,441416,34581569,N,NULL,9,25/11/2020,NULL
250316,175558,24,23/11/2022,35013838,1173100,740831,432270,33840738,N,NULL,9,25/11/2020,NULL
250317,175558,25,23/12/2022,34263747,1173100,750091,423009,33090647,N,NULL,9,25/11/2020,NULL
250318,175558,26,23/01/2023,33504280,1173100,759467,413633,32331180,N,NULL,9,25/11/2020,NULL
250319,175558,27,23/02/2023,32735319,1173100,768961,404140,31562219,N,NULL,9,25/11/2020,NULL
250320,175558,28,23/03/2023,31956746,1173100,778573,394528,30783646,N,NULL,9,25/11/2020,NULL
250321,175558,29,23/04/2023,31168441,1173100,788305,384796,29995341,N,NULL,9,25/11/2020,NULL
250322,175558,30,23/05/2023,30370283,1173100,798158,374942,29197183,N,NULL,9,25/11/2020,NULL
250323,175558,31,23/06/2023,29562148,1173100,808135,364965,28389048,N,NULL,9,25/11/2020,NULL
250324,175558,32,23/07/2023,28743911,1173100,818237,354863,27570811,N,NULL,9,25/11/2020,NULL
250325,175558,33,23/08/2023,27915446,1173100,828465,344635,26742346,N,NULL,9,25/11/2020,NULL
250326,175558,34,23/09/2023,27076625,1173100,838821,334279,25903525,N,NULL,9,25/11/2020,NULL
250327,175558,35,23/10/2023,26227319,1173100,849306,323794,25054219,N,NULL,9,25/11/2020,NULL
250328,175558,36,23/11/2023,25367396,1173100,859923,313178,24194296,N,NULL,9,25/11/2020,NULL
250329,175558,37,23/12/2023,24496724,1173100,870672,302429,23323624,N,NULL,9,25/11/2020,NULL
250330,175558,38,23/01/2024,23615169,1173100,881555,291545,22442069,N,NULL,9,25/11/2020,NULL
250331,175558,39,23/02/2024,22722595,1173100,892574,280526,21549495,N,NULL,9,25/11/2020,NULL
250332,175558,40,23/03/2024,21818863,1173100,903732,269369,20645763,N,NULL,9,25/11/2020,NULL
250333,175558,41,23/04/2024,20903835,1173100,915028,258072,19730735,N,NULL,9,25/11/2020,NULL
250334,175558,42,23/05/2024,19977369,1173100,926466,246634,18804269,N,NULL,9,25/11/2020,NULL
250335,175558,43,23/06/2024,19039322,1173100,938047,235053,17866222,N,NULL,9,25/11/2020,NULL
250336,175558,44,23/07/2024,18089550,1173100,949772,223328,16916450,N,NULL,9,25/11/2020,NULL
250337,175558,45,23/08/2024,17127905,1173100,961645,211456,15954805,N,NULL,9,25/11/2020,NULL
250338,175558,46,23/09/2024,16154240,1173100,973665,199435,14981140,N,NULL,9,25/11/2020,NULL
250339,175558,47,23/10/2024,15168404,1173100,985836,187264,13995304,N,NULL,9,25/11/2020,NULL
250340,175558,48,23/11/2024,14170245,1173100,998159,174941,12997145,N,NULL,9,25/11/2020,NULL
250341,175558,49,23/12/2024,13159609,1173100,1010636,162464,11986509,N,NULL,9,25/11/2020,NULL
250342,175558,50,23/01/2025,12136340,1173100,1023269,149831,10963240,N,NULL,9,25/11/2020,NULL
250343,175558,51,23/02/2025,11100280,1173100,1036060,137040,9927180,N,NULL,9,25/11/2020,NULL
250344,175558,52,23/03/2025,10051270,1173100,1049010,124090,8878170,N,NULL,9,25/11/2020,NULL
250345,175558,53,23/04/2025,8989147,1173100,1062123,110977,7816047,N,NULL,9,25/11/2020,NULL
250346,175558,54,23/05/2025,7913747,1173100,1075400,97701,6740647,N,NULL,9,25/11/2020,NULL
250347,175558,55,23/06/2025,6824905,1173100,1088842,84258,5651805,N,NULL,9,25/11/2020,NULL
250348,175558,56,23/07/2025,5722452,1173100,1102453,70648,4549352,N,NULL,9,25/11/2020,NULL
250349,175558,57,23/08/2025,4606219,1173100,1116233,56867,3433119,N,NULL,9,25/11/2020,NULL
250350,175558,58,23/09/2025,3476033,1173100,1130186,42914,2302933,N,NULL,9,25/11/2020,NULL
250351,175558,59,23/10/2025,2331719,1173100,1144314,28787,1158619,N,NULL,9,25/11/2020,NULL
250352,175558,60,23/11/2025,1173101,1173100,1158619,14483,0,N,NULL,9,25/11/2020,NULL
250353,175560,1,23/12/2020,10124369,484836,359844,124992,9639533,N,NULL,9,25/11/2020,NULL
250354,175560,2,23/01/2021,9760027,484836,364342,120494,9275191,N,NULL,9,25/11/2020,NULL
250355,175560,3,23/02/2021,9391131,484836,368896,115940,8906295,N,NULL,9,25/11/2020,NULL
250356,175560,4,23/03/2021,9017623,484836,373508,111329,8532787,N,NULL,9,25/11/2020,NULL
250357,175560,5,23/04/2021,8639447,484836,378176,106660,8154611,N,NULL,9,25/11/2020,NULL
250358,175560,6,23/05/2021,8256543,484836,382904,101933,7771707,N,NULL,9,25/11/2020,NULL
250359,175560,7,23/06/2021,7868853,484836,387690,97146,7384017,N,NULL,9,25/11/2020,NULL
250360,175560,8,23/07/2021,7476317,484836,392536,92300,6991481,N,NULL,9,25/11/2020,NULL
250361,175560,9,23/08/2021,7078874,484836,397443,87394,6594038,N,NULL,9,25/11/2020,NULL
250362,175560,10,23/09/2021,6676463,484836,402411,82425,6191627,N,NULL,9,25/11/2020,NULL
250363,175560,11,23/10/2021,6269022,484836,407441,77395,5784186,N,NULL,9,25/11/2020,NULL
250364,175560,12,23/11/2021,5856488,484836,412534,72302,5371652,N,NULL,9,25/11/2020,NULL
250365,175560,13,23/12/2021,5438797,484836,417691,67146,4953961,N,NULL,9,25/11/2020,NULL
250366,175560,14,23/01/2022,5015885,484836,422912,61925,4531049,N,NULL,9,25/11/2020,NULL
250367,175560,15,23/02/2022,4587687,484836,428198,56638,4102851,N,NULL,9,25/11/2020,NULL
250368,175560,16,23/03/2022,4154136,484836,433551,51286,3669300,N,NULL,9,25/11/2020,NULL
250369,175560,17,23/04/2022,3715166,484836,438970,45866,3230330,N,NULL,9,25/11/2020,NULL
250370,175560,18,23/05/2022,3270709,484836,444457,40379,2785873,N,NULL,9,25/11/2020,NULL
250371,175560,19,23/06/2022,2820696,484836,450013,34823,2335860,N,NULL,9,25/11/2020,NULL
250372,175560,20,23/07/2022,2365058,484836,455638,29198,1880222,N,NULL,9,25/11/2020,NULL
250373,175560,21,23/08/2022,1903725,484836,461333,23503,1418889,N,NULL,9,25/11/2020,NULL
250374,175560,22,23/09/2022,1436625,484836,467100,17736,951789,N,NULL,9,25/11/2020,NULL
250375,175560,23,23/10/2022,963686,484836,472939,11897,478850,N,NULL,9,25/11/2020,NULL
250376,175560,24,23/11/2022,484835,484836,478850,5986,0,N,NULL,9,25/11/2020,NULL
250377,175561,1,25/12/2020,9112500,1566304,1453804,112500,7546196,N,NULL,9,26/11/2020,NULL
250378,175561,2,25/01/2021,7640523,1566304,1471977,94327,6074219,N,NULL,9,26/11/2020,NULL
250379,175561,3,25/02/2021,6150146,1566304,1490377,75928,4583842,N,NULL,9,26/11/2020,NULL
250380,175561,4,25/03/2021,4641140,1566304,1509006,57298,3074836,N,NULL,9,26/11/2020,NULL
250381,175561,5,25/04/2021,3113271,1566304,1527869,38435,1546967,N,NULL,9,26/11/2020,NULL
250382,175561,6,25/05/2021,1566304,1566304,1546967,19337,0,N,NULL,9,26/11/2020,NULL
250383,175562,1,25/12/2020,2025000,683402,658402,25000,1341598,N,NULL,9,26/11/2020,NULL
250384,175562,2,25/01/2021,1358368,683402,666632,16770,674966,N,NULL,9,26/11/2020,NULL
250385,175562,3,25/02/2021,683403,683402,674966,8437,0,N,NULL,9,26/11/2020,NULL
250386,175563,1,25/12/2020,51196716,1202930,570871,632058,49993786,N,NULL,9,26/11/2020,NULL
250387,175563,2,25/01/2021,50618709,1202930,578007,624922,49415779,N,NULL,9,26/11/2020,NULL
250388,175563,3,25/02/2021,50033477,1202930,585232,617697,48830547,N,NULL,9,26/11/2020,NULL
250389,175563,4,25/03/2021,49440929,1202930,592548,610382,48237999,N,NULL,9,26/11/2020,NULL
250390,175563,5,25/04/2021,48840974,1202930,599955,602975,47638044,N,NULL,9,26/11/2020,NULL
250391,175563,6,25/05/2021,48233520,1202930,607454,595476,47030590,N,NULL,9,26/11/2020,NULL
250392,175563,7,25/06/2021,47618473,1202930,615047,587882,46415543,N,NULL,9,26/11/2020,NULL
250393,175563,8,25/07/2021,46995738,1202930,622735,580194,45792808,N,NULL,9,26/11/2020,NULL
250394,175563,9,25/08/2021,46365218,1202930,630520,572410,45162288,N,NULL,9,26/11/2020,NULL
250395,175563,10,25/09/2021,45726817,1202930,638401,564529,44523887,N,NULL,9,26/11/2020,NULL
250396,175563,11,25/10/2021,45080436,1202930,646381,556549,43877506,N,NULL,9,26/11/2020,NULL
250397,175563,12,25/11/2021,44425975,1202930,654461,548469,43223045,N,NULL,9,26/11/2020,NULL
250398,175563,13,25/12/2021,43763333,1202930,662642,540288,42560403,N,NULL,9,26/11/2020,NULL
250399,175563,14,25/01/2022,43092408,1202930,670925,532005,41889478,N,NULL,9,26/11/2020,NULL
250400,175563,15,25/02/2022,42413097,1202930,679311,523618,41210167,N,NULL,9,26/11/2020,NULL
250401,175563,16,25/03/2022,41725294,1202930,687803,515127,40522364,N,NULL,9,26/11/2020,NULL
250402,175563,17,25/04/2022,41028894,1202930,696400,506530,39825964,N,NULL,9,26/11/2020,NULL
250403,175563,18,25/05/2022,40323789,1202930,705105,497825,39120859,N,NULL,9,26/11/2020,NULL
250404,175563,19,25/06/2022,39609870,1202930,713919,489011,38406940,N,NULL,9,26/11/2020,NULL
250405,175563,20,25/07/2022,38887027,1202930,722843,480087,37684097,N,NULL,9,26/11/2020,NULL
250406,175563,21,25/08/2022,38155149,1202930,731878,471051,36952219,N,NULL,9,26/11/2020,NULL
250407,175563,22,25/09/2022,37414122,1202930,741027,461903,36211192,N,NULL,9,26/11/2020,NULL
250408,175563,23,25/10/2022,36663832,1202930,750290,452640,35460902,N,NULL,9,26/11/2020,NULL
250409,175563,24,25/11/2022,35904164,1202930,759668,443261,34701234,N,NULL,9,26/11/2020,NULL
250410,175563,25,25/12/2022,35135000,1202930,769164,433765,33932070,N,NULL,9,26/11/2020,NULL
250411,175563,26,25/01/2023,34356221,1202930,778779,424151,33153291,N,NULL,9,26/11/2020,NULL
250412,175563,27,25/02/2023,33567707,1202930,788514,414416,32364777,N,NULL,9,26/11/2020,NULL
250413,175563,28,25/03/2023,32769337,1202930,798370,404560,31566407,N,NULL,9,26/11/2020,NULL
250414,175563,29,25/04/2023,31960987,1202930,808350,394580,30758057,N,NULL,9,26/11/2020,NULL
250415,175563,30,25/05/2023,31142533,1202930,818454,384476,29939603,N,NULL,9,26/11/2020,NULL
250416,175563,31,25/06/2023,30313848,1202930,828685,374245,29110918,N,NULL,9,26/11/2020,NULL
250417,175563,32,25/07/2023,29474805,1202930,839043,363886,28271875,N,NULL,9,26/11/2020,NULL
250418,175563,33,25/08/2023,28625274,1202930,849531,353398,27422344,N,NULL,9,26/11/2020,NULL
250419,175563,34,25/09/2023,27765124,1202930,860150,342779,26562194,N,NULL,9,26/11/2020,NULL
250420,175563,35,25/10/2023,26894222,1202930,870902,332027,25691292,N,NULL,9,26/11/2020,NULL
250421,175563,36,25/11/2023,26012433,1202930,881789,321141,24809503,N,NULL,9,26/11/2020,NULL
250422,175563,37,25/12/2023,25119622,1202930,892811,310119,23916692,N,NULL,9,26/11/2020,NULL
250423,175563,38,25/01/2024,24215651,1202930,903971,298959,23012721,N,NULL,9,26/11/2020,NULL
250424,175563,39,25/02/2024,23300380,1202930,915271,287659,22097450,N,NULL,9,26/11/2020,NULL
250425,175563,40,25/03/2024,22373668,1202930,926712,276218,21170738,N,NULL,9,26/11/2020,NULL
250426,175563,41,25/04/2024,21435373,1202930,938295,264634,20232443,N,NULL,9,26/11/2020,NULL
250427,175563,42,25/05/2024,20485349,1202930,950024,252906,19282419,N,NULL,9,26/11/2020,NULL
250428,175563,43,25/06/2024,19523450,1202930,961899,241030,18320520,N,NULL,9,26/11/2020,NULL
250429,175563,44,25/07/2024,18549527,1202930,973923,229007,17346597,N,NULL,9,26/11/2020,NULL
250430,175563,45,25/08/2024,17563430,1202930,986097,216832,16360500,N,NULL,9,26/11/2020,NULL
250431,175563,46,25/09/2024,16565007,1202930,998423,204506,15362077,N,NULL,9,26/11/2020,NULL
250432,175563,47,25/10/2024,15554103,1202930,1010904,192026,14351173,N,NULL,9,26/11/2020,NULL
250433,175563,48,25/11/2024,14530563,1202930,1023540,179390,13327633,N,NULL,9,26/11/2020,NULL
250434,175563,49,25/12/2024,13494229,1202930,1036334,166595,12291299,N,NULL,9,26/11/2020,NULL
250435,175563,50,25/01/2025,12444941,1202930,1049288,153641,11242011,N,NULL,9,26/11/2020,NULL
250436,175563,51,25/02/2025,11382536,1202930,1062405,140525,10179606,N,NULL,9,26/11/2020,NULL
250437,175563,52,25/03/2025,10306851,1202930,1075685,127245,9103921,N,NULL,9,26/11/2020,NULL
250438,175563,53,25/04/2025,9217720,1202930,1089131,113799,8014790,N,NULL,9,26/11/2020,NULL
250439,175563,54,25/05/2025,8114975,1202930,1102745,100185,6912045,N,NULL,9,26/11/2020,NULL
250440,175563,55,25/06/2025,6998446,1202930,1116529,86401,5795516,N,NULL,9,26/11/2020,NULL
250441,175563,56,25/07/2025,5867960,1202930,1130486,72444,4665030,N,NULL,9,26/11/2020,NULL
250442,175563,57,25/08/2025,4723343,1202930,1144617,58313,3520413,N,NULL,9,26/11/2020,NULL
250443,175563,58,25/09/2025,3564419,1202930,1158924,44005,2361489,N,NULL,9,26/11/2020,NULL
250444,175563,59,25/10/2025,2391008,1202930,1173411,29519,1188078,N,NULL,9,26/11/2020,NULL
250445,175563,60,25/11/2025,1202929,1202930,1188078,14851,0,N,NULL,9,26/11/2020,NULL
250446,175564,1,26/12/2020,9925685,1048967,926427,122539,8876718,N,NULL,9,26/11/2020,NULL
250447,175564,2,26/01/2021,8987677,1048967,938008,110959,7938710,N,NULL,9,26/11/2020,NULL
250448,175564,3,26/02/2021,8037944,1048967,949733,99234,6988977,N,NULL,9,26/11/2020,NULL
250449,175564,4,26/03/2021,7076340,1048967,961604,87362,6027373,N,NULL,9,26/11/2020,NULL
250450,175564,5,26/04/2021,6102716,1048967,973624,75342,5053749,N,NULL,9,26/11/2020,NULL
250451,175564,6,26/05/2021,5116921,1048967,985795,63172,4067954,N,NULL,9,26/11/2020,NULL
250452,175564,7,26/06/2021,4118804,1048967,998117,50849,3069837,N,NULL,9,26/11/2020,NULL
250453,175564,8,26/07/2021,3108210,1048967,1010594,38373,2059243,N,NULL,9,26/11/2020,NULL
250454,175564,9,26/08/2021,2084984,1048967,1023226,25741,1036017,N,NULL,9,26/11/2020,NULL
250455,175564,10,26/09/2021,1048968,1048967,1036017,12950,0,N,NULL,9,26/11/2020,NULL
250456,175565,1,26/12/2020,405000,136680,131680,5000,268320,N,NULL,9,26/11/2020,NULL
250457,175565,2,26/01/2021,271674,136680,133326,3354,134994,N,NULL,9,26/11/2020,NULL
250458,175565,3,26/02/2021,136681,136680,134994,1687,0,N,NULL,9,26/11/2020,NULL
250459,175566,1,26/12/2020,709917,709917,700000,9917,0,N,NULL,9,26/11/2020,NULL
250460,175567,1,26/12/2020,5670000,505447,435447,70000,5164553,N,NULL,9,26/11/2020,NULL
250461,175567,2,26/01/2021,5229110,505447,440890,64557,4723663,N,NULL,9,26/11/2020,NULL
250462,175567,3,26/02/2021,4782709,505447,446401,59046,4277262,N,NULL,9,26/11/2020,NULL
250463,175567,4,26/03/2021,4330728,505447,451981,53466,3825281,N,NULL,9,26/11/2020,NULL
250464,175567,5,26/04/2021,3873097,505447,457631,47816,3367650,N,NULL,9,26/11/2020,NULL
250465,175567,6,26/05/2021,3409746,505447,463351,42096,2904299,N,NULL,9,26/11/2020,NULL
250466,175567,7,26/06/2021,2940603,505447,469143,36304,2435156,N,NULL,9,26/11/2020,NULL
250467,175567,8,26/07/2021,2465596,505447,475007,30439,1960149,N,NULL,9,26/11/2020,NULL
250468,175567,9,26/08/2021,1984651,505447,480945,24502,1479204,N,NULL,9,26/11/2020,NULL
250469,175567,10,26/09/2021,1497695,505447,486956,18490,992248,N,NULL,9,26/11/2020,NULL
250470,175567,11,26/10/2021,1004652,505447,493043,12403,499205,N,NULL,9,26/11/2020,NULL
250471,175567,12,26/11/2021,505446,505447,499205,6240,0,N,NULL,9,26/11/2020,NULL
250472,175568,1,26/12/2020,2531250,375222,343972,31250,2156028,N,NULL,9,26/11/2020,NULL
250473,175568,2,26/01/2021,2182979,375222,348271,26950,1807757,N,NULL,9,26/11/2020,NULL
250474,175568,3,26/02/2021,1830354,375222,352625,22597,1455132,N,NULL,9,26/11/2020,NULL
250475,175568,4,26/03/2021,1473321,375222,357033,18189,1098099,N,NULL,9,26/11/2020,NULL
250476,175568,5,26/04/2021,1111825,375222,361496,13726,736603,N,NULL,9,26/11/2020,NULL
250477,175568,6,26/05/2021,745811,375222,366014,9208,370589,N,NULL,9,26/11/2020,NULL
250478,175568,7,26/06/2021,375222,375222,370589,4632,0,N,NULL,9,26/11/2020,NULL
250539,175570,1,27/12/2020,5832688,1002553,930544,72008,4830135,N,NULL,9,30/11/2020,NULL
250540,175570,2,27/01/2021,4890512,1002553,942176,60377,3887959,N,NULL,9,30/11/2020,NULL
250541,175570,3,27/02/2021,3936559,1002553,953953,48599,2934006,N,NULL,9,30/11/2020,NULL
250542,175570,4,27/03/2021,2970681,1002553,965878,36675,1968128,N,NULL,9,30/11/2020,NULL
250543,175570,5,27/04/2021,1992730,1002553,977951,24602,990177,N,NULL,9,30/11/2020,NULL
250544,175570,6,27/05/2021,1002554,1002553,990177,12377,0,N,NULL,9,30/11/2020,NULL
250545,175571,1,27/12/2020,10124665,484850,359855,124996,9639815,N,NULL,9,30/11/2020,NULL
250546,175571,2,27/01/2021,9760312,484850,364353,120498,9275462,N,NULL,9,30/11/2020,NULL
250547,175571,3,27/02/2021,9391405,484850,368907,115943,8906555,N,NULL,9,30/11/2020,NULL
250548,175571,4,27/03/2021,9017886,484850,373519,111332,8533036,N,NULL,9,30/11/2020,NULL
250549,175571,5,27/04/2021,8639698,484850,378188,106663,8154848,N,NULL,9,30/11/2020,NULL
250550,175571,6,27/05/2021,8256783,484850,382915,101936,7771933,N,NULL,9,30/11/2020,NULL
250551,175571,7,27/06/2021,7869082,484850,387701,97149,7384232,N,NULL,9,30/11/2020,NULL
250552,175571,8,27/07/2021,7476534,484850,392548,92303,6991684,N,NULL,9,30/11/2020,NULL
250553,175571,9,27/08/2021,7079080,484850,397454,87396,6594230,N,NULL,9,30/11/2020,NULL
250554,175571,10,27/09/2021,6676657,484850,402423,82428,6191807,N,NULL,9,30/11/2020,NULL
250555,175571,11,27/10/2021,6269204,484850,407453,77398,5784354,N,NULL,9,30/11/2020,NULL
250556,175571,12,27/11/2021,5856658,484850,412546,72304,5371808,N,NULL,9,30/11/2020,NULL
250557,175571,13,27/12/2021,5438955,484850,417703,67148,4954105,N,NULL,9,30/11/2020,NULL
250558,175571,14,27/01/2022,5016031,484850,422924,61926,4531181,N,NULL,9,30/11/2020,NULL
250559,175571,15,27/02/2022,4587820,484850,428211,56640,4102970,N,NULL,9,30/11/2020,NULL
250560,175571,16,27/03/2022,4154257,484850,433563,51287,3669407,N,NULL,9,30/11/2020,NULL
250561,175571,17,27/04/2022,3715274,484850,438983,45868,3230424,N,NULL,9,30/11/2020,NULL
250562,175571,18,27/05/2022,3270804,484850,444470,40380,2785954,N,NULL,9,30/11/2020,NULL
250563,175571,19,27/06/2022,2820778,484850,450026,34824,2335928,N,NULL,9,30/11/2020,NULL
250564,175571,20,27/07/2022,2365127,484850,455651,29199,1880277,N,NULL,9,30/11/2020,NULL
250565,175571,21,27/08/2022,1903780,484850,461347,23503,1418930,N,NULL,9,30/11/2020,NULL
250566,175571,22,27/09/2022,1436666,484850,467114,17737,951816,N,NULL,9,30/11/2020,NULL
250567,175571,23,27/10/2022,963713,484850,472953,11898,478863,N,NULL,9,30/11/2020,NULL
250568,175571,24,27/11/2022,484848,484850,478863,5986,0,N,NULL,9,30/11/2020,NULL
250569,175572,1,27/12/2020,128630972,3022343,1434306,1588037,125608629,N,NULL,9,1/12/2020,NULL
250570,175572,2,27/01/2021,127178737,3022343,1452235,1570108,124156394,N,NULL,9,1/12/2020,NULL
250571,175572,3,27/02/2021,125708349,3022343,1470388,1551955,122686006,N,NULL,9,1/12/2020,NULL
250572,175572,4,27/03/2021,124219582,3022343,1488767,1533575,121197239,N,NULL,9,1/12/2020,NULL
250573,175572,5,27/04/2021,122712205,3022343,1507377,1514965,119689862,N,NULL,9,1/12/2020,NULL
250574,175572,6,27/05/2021,121185986,3022343,1526219,1496123,118163643,N,NULL,9,1/12/2020,NULL
250575,175572,7,27/06/2021,119640689,3022343,1545297,1477046,116618346,N,NULL,9,1/12/2020,NULL
250576,175572,8,27/07/2021,118076076,3022343,1564613,1457729,115053733,N,NULL,9,1/12/2020,NULL
250577,175572,9,27/08/2021,116491905,3022343,1584171,1438172,113469562,N,NULL,9,1/12/2020,NULL
250578,175572,10,27/09/2021,114887932,3022343,1603973,1418370,111865589,N,NULL,9,1/12/2020,NULL
250579,175572,11,27/10/2021,113263909,3022343,1624023,1398320,110241566,N,NULL,9,1/12/2020,NULL
250580,175572,12,27/11/2021,111619586,3022343,1644323,1378020,108597243,N,NULL,9,1/12/2020,NULL
250581,175572,13,27/12/2021,109954709,3022343,1664877,1357466,106932366,N,NULL,9,1/12/2020,NULL
250582,175572,14,27/01/2022,108269021,3022343,1685688,1336655,105246678,N,NULL,9,1/12/2020,NULL
250583,175572,15,27/02/2022,106562262,3022343,1706759,1315583,103539919,N,NULL,9,1/12/2020,NULL
250584,175572,16,27/03/2022,104834168,3022343,1728094,1294249,101811825,N,NULL,9,1/12/2020,NULL
250585,175572,17,27/04/2022,103084473,3022343,1749695,1272648,100062130,N,NULL,9,1/12/2020,NULL
250586,175572,18,27/05/2022,101312907,3022343,1771566,1250777,98290564,N,NULL,9,1/12/2020,NULL
250587,175572,19,27/06/2022,99519197,3022343,1793710,1228632,96496854,N,NULL,9,1/12/2020,NULL
250588,175572,20,27/07/2022,97703065,3022343,1816132,1206211,94680722,N,NULL,9,1/12/2020,NULL
250589,175572,21,27/08/2022,95864231,3022343,1838834,1183509,92841888,N,NULL,9,1/12/2020,NULL
250590,175572,22,27/09/2022,94002412,3022343,1861819,1160524,90980069,N,NULL,9,1/12/2020,NULL
250591,175572,23,27/10/2022,92117320,3022343,1885092,1137251,89094977,N,NULL,9,1/12/2020,NULL
250592,175572,24,27/11/2022,90208665,3022343,1908655,1113687,87186322,N,NULL,9,1/12/2020,NULL
250593,175572,25,27/12/2022,88276152,3022343,1932513,1089829,85253809,N,NULL,9,1/12/2020,NULL
250594,175572,26,27/01/2023,86319482,3022343,1956670,1065673,83297139,N,NULL,9,1/12/2020,NULL
250595,175572,27,27/02/2023,84338354,3022343,1981128,1041214,81316011,N,NULL,9,1/12/2020,NULL
250596,175572,28,27/03/2023,82332462,3022343,2005892,1016450,79310119,N,NULL,9,1/12/2020,NULL
250597,175572,29,27/04/2023,80301496,3022343,2030966,991376,77279153,N,NULL,9,1/12/2020,NULL
250598,175572,30,27/05/2023,78245143,3022343,2056353,965989,75222800,N,NULL,9,1/12/2020,NULL
250599,175572,31,27/06/2023,76163085,3022343,2082058,940285,73140742,N,NULL,9,1/12/2020,NULL
250600,175572,32,27/07/2023,74055002,3022343,2108083,914259,71032659,N,NULL,9,1/12/2020,NULL
250601,175572,33,27/08/2023,71920568,3022343,2134434,887908,68898225,N,NULL,9,1/12/2020,NULL
250602,175572,34,27/09/2023,69759453,3022343,2161115,861228,66737110,N,NULL,9,1/12/2020,NULL
250603,175572,35,27/10/2023,67571324,3022343,2188129,834214,64548981,N,NULL,9,1/12/2020,NULL
250604,175572,36,27/11/2023,65355844,3022343,2215480,806862,62333501,N,NULL,9,1/12/2020,NULL
250605,175572,37,27/12/2023,63112670,3022343,2243174,779169,60090327,N,NULL,9,1/12/2020,NULL
250606,175572,38,27/01/2024,60841457,3022343,2271213,751129,57819114,N,NULL,9,1/12/2020,NULL
250607,175572,39,27/02/2024,58541853,3022343,2299604,722739,55519510,N,NULL,9,1/12/2020,NULL
250608,175572,40,27/03/2024,56213504,3022343,2328349,693994,53191161,N,NULL,9,1/12/2020,NULL
250609,175572,41,27/04/2024,53856051,3022343,2357453,664890,50833708,N,NULL,9,1/12/2020,NULL
250610,175572,42,27/05/2024,51469130,3022343,2386921,635421,48446787,N,NULL,9,1/12/2020,NULL
250611,175572,43,27/06/2024,49052372,3022343,2416758,605585,46030029,N,NULL,9,1/12/2020,NULL
250612,175572,44,27/07/2024,46605405,3022343,2446967,575375,43583062,N,NULL,9,1/12/2020,NULL
250613,175572,45,27/08/2024,44127851,3022343,2477554,544788,41105508,N,NULL,9,1/12/2020,NULL
250614,175572,46,27/09/2024,41619327,3022343,2508524,513819,38596984,N,NULL,9,1/12/2020,NULL
250615,175572,47,27/10/2024,39079447,3022343,2539880,482462,36057104,N,NULL,9,1/12/2020,NULL
250616,175572,48,27/11/2024,36507818,3022343,2571629,450714,33485475,N,NULL,9,1/12/2020,NULL
250617,175572,49,27/12/2024,33904044,3022343,2603774,418568,30881701,N,NULL,9,1/12/2020,NULL
250618,175572,50,27/01/2025,31267723,3022343,2636321,386021,28245380,N,NULL,9,1/12/2020,NULL
250619,175572,51,27/02/2025,28598448,3022343,2669275,353067,25576105,N,NULL,9,1/12/2020,NULL
250620,175572,52,27/03/2025,25895807,3022343,2702641,319701,22873464,N,NULL,9,1/12/2020,NULL
250621,175572,53,27/04/2025,23159383,3022343,2736424,285918,20137040,N,NULL,9,1/12/2020,NULL
250622,175572,54,27/05/2025,20388753,3022343,2770630,251713,17366410,N,NULL,9,1/12/2020,NULL
250623,175572,55,27/06/2025,17583491,3022343,2805262,217080,14561148,N,NULL,9,1/12/2020,NULL
250624,175572,56,27/07/2025,14743163,3022343,2840328,182014,11720820,N,NULL,9,1/12/2020,NULL
250625,175572,57,27/08/2025,11867331,3022343,2875832,146510,8844988,N,NULL,9,1/12/2020,NULL
250626,175572,58,27/09/2025,8955551,3022343,2911780,110562,5933208,N,NULL,9,1/12/2020,NULL
250627,175572,59,27/10/2025,6007374,3022343,2948177,74165,2985031,N,NULL,9,1/12/2020,NULL
250628,175572,60,27/11/2025,3022344,3022343,2985031,37313,0,N,NULL,9,1/12/2020,NULL
250629,175573,1,27/12/2020,35000654,1198330,766223,432107,33802324,N,NULL,9,1/12/2020,NULL
250630,175573,2,27/01/2021,34224853,1198330,775801,422529,33026523,N,NULL,9,1/12/2020,NULL
250631,175573,3,27/02/2021,33439354,1198330,785499,412832,32241024,N,NULL,9,1/12/2020,NULL
250632,175573,4,27/03/2021,32644037,1198330,795317,403013,31445707,N,NULL,9,1/12/2020,NULL
250633,175573,5,27/04/2021,31838778,1198330,805259,393071,30640448,N,NULL,9,1/12/2020,NULL
250634,175573,6,27/05/2021,31023454,1198330,815324,383006,29825124,N,NULL,9,1/12/2020,NULL
250635,175573,7,27/06/2021,30197938,1198330,825516,372814,28999608,N,NULL,9,1/12/2020,NULL
250636,175573,8,27/07/2021,29362103,1198330,835835,362495,28163773,N,NULL,9,1/12/2020,NULL
250637,175573,9,27/08/2021,28515820,1198330,846283,352047,27317490,N,NULL,9,1/12/2020,NULL
250638,175573,10,27/09/2021,27658959,1198330,856861,341469,26460629,N,NULL,9,1/12/2020,NULL
250639,175573,11,27/10/2021,26791387,1198330,867572,330758,25593057,N,NULL,9,1/12/2020,NULL
250640,175573,12,27/11/2021,25912970,1198330,878417,319913,24714640,N,NULL,9,1/12/2020,NULL
250641,175573,13,27/12/2021,25023573,1198330,889397,308933,23825243,N,NULL,9,1/12/2020,NULL
250642,175573,14,27/01/2022,24123058,1198330,900515,297816,22924728,N,NULL,9,1/12/2020,NULL
250643,175573,15,27/02/2022,23211287,1198330,911771,286559,22012957,N,NULL,9,1/12/2020,NULL
250644,175573,16,27/03/2022,22288119,1198330,923168,275162,21089789,N,NULL,9,1/12/2020,NULL
250645,175573,17,27/04/2022,21353411,1198330,934708,263622,20155081,N,NULL,9,1/12/2020,NULL
250646,175573,18,27/05/2022,20407019,1198330,946392,251939,19208689,N,NULL,9,1/12/2020,NULL
250647,175573,19,27/06/2022,19448798,1198330,958221,240109,18250468,N,NULL,9,1/12/2020,NULL
250648,175573,20,27/07/2022,18478599,1198330,970199,228131,17280269,N,NULL,9,1/12/2020,NULL
250649,175573,21,27/08/2022,17496272,1198330,982327,216003,16297942,N,NULL,9,1/12/2020,NULL
250650,175573,22,27/09/2022,16501666,1198330,994606,203724,15303336,N,NULL,9,1/12/2020,NULL
250651,175573,23,27/10/2022,15494628,1198330,1007038,191292,14296298,N,NULL,9,1/12/2020,NULL
250652,175573,24,27/11/2022,14475002,1198330,1019626,178704,13276672,N,NULL,9,1/12/2020,NULL
250653,175573,25,27/12/2022,13442630,1198330,1032372,165958,12244300,N,NULL,9,1/12/2020,NULL
250654,175573,26,27/01/2023,12397354,1198330,1045276,153054,11199024,N,NULL,9,1/12/2020,NULL
250655,175573,27,27/02/2023,11339012,1198330,1058342,139988,10140682,N,NULL,9,1/12/2020,NULL
250656,175573,28,27/03/2023,10267440,1198330,1071572,126759,9069110,N,NULL,9,1/12/2020,NULL
250657,175573,29,27/04/2023,9182474,1198330,1084966,113364,7984144,N,NULL,9,1/12/2020,NULL
250658,175573,30,27/05/2023,8083946,1198330,1098528,99802,6885616,N,NULL,9,1/12/2020,NULL
250659,175573,31,27/06/2023,6971686,1198330,1112260,86070,5773356,N,NULL,9,1/12/2020,NULL
250660,175573,32,27/07/2023,5845523,1198330,1126163,72167,4647193,N,NULL,9,1/12/2020,NULL
250661,175573,33,27/08/2023,4705283,1198330,1140240,58090,3506953,N,NULL,9,1/12/2020,NULL
250662,175573,34,27/09/2023,3550790,1198330,1154493,43837,2352460,N,NULL,9,1/12/2020,NULL
250663,175573,35,27/10/2023,2381866,1198330,1168924,29406,1183536,N,NULL,9,1/12/2020,NULL
250664,175573,36,27/11/2023,1198330,1198330,1183536,14794,0,N,NULL,9,1/12/2020,NULL
250665,175574,1,27/12/2020,10111080,901342,776514,124828,9209738,N,NULL,9,1/12/2020,NULL
250666,175574,2,27/01/2021,9324859,901342,786221,115122,8423517,N,NULL,9,1/12/2020,NULL
250667,175574,3,27/02/2021,8528811,901342,796048,105294,7627469,N,NULL,9,1/12/2020,NULL
250668,175574,4,27/03/2021,7722812,901342,805999,95343,6821470,N,NULL,9,1/12/2020,NULL
250669,175574,5,27/04/2021,6906738,901342,816074,85268,6005396,N,NULL,9,1/12/2020,NULL
250670,175574,6,27/05/2021,6080463,901342,826275,75067,5179121,N,NULL,9,1/12/2020,NULL
250671,175574,7,27/06/2021,5243860,901342,836603,64739,4342518,N,NULL,9,1/12/2020,NULL
250672,175574,8,27/07/2021,4396799,901342,847061,54281,3495457,N,NULL,9,1/12/2020,NULL
250673,175574,9,27/08/2021,3539150,901342,857649,43693,2637808,N,NULL,9,1/12/2020,NULL
250674,175574,10,27/09/2021,2670780,901342,868370,32973,1769438,N,NULL,9,1/12/2020,NULL
250675,175574,11,27/10/2021,1791556,901342,879224,22118,890214,N,NULL,9,1/12/2020,NULL
250676,175574,12,27/11/2021,901341,901342,890214,11128,0,N,NULL,9,1/12/2020,NULL
250677,175575,1,27/12/2020,10116267,484448,359556,124892,9631819,N,NULL,9,1/12/2020,NULL
250678,175575,2,27/01/2021,9752216,484448,364051,120398,9267768,N,NULL,9,1/12/2020,NULL
250679,175575,3,27/02/2021,9383615,484448,368601,115847,8899167,N,NULL,9,1/12/2020,NULL
250680,175575,4,27/03/2021,9010406,484448,373209,111240,8525958,N,NULL,9,1/12/2020,NULL
250681,175575,5,27/04/2021,8632532,484448,377874,106574,8148084,N,NULL,9,1/12/2020,NULL
250682,175575,6,27/05/2021,8249935,484448,382597,101851,7765487,N,NULL,9,1/12/2020,NULL
250683,175575,7,27/06/2021,7862555,484448,387380,97069,7378107,N,NULL,9,1/12/2020,NULL
250684,175575,8,27/07/2021,7470333,484448,392222,92226,6985885,N,NULL,9,1/12/2020,NULL
250685,175575,9,27/08/2021,7073208,484448,397125,87324,6588760,N,NULL,9,1/12/2020,NULL
250686,175575,10,27/09/2021,6671119,484448,402089,82360,6186671,N,NULL,9,1/12/2020,NULL
250687,175575,11,27/10/2021,6264004,484448,407115,77333,5779556,N,NULL,9,1/12/2020,NULL
250688,175575,12,27/11/2021,5851800,484448,412204,72244,5367352,N,NULL,9,1/12/2020,NULL
250689,175575,13,27/12/2021,5434444,484448,417356,67092,4949996,N,NULL,9,1/12/2020,NULL
250690,175575,14,27/01/2022,5011871,484448,422573,61875,4527423,N,NULL,9,1/12/2020,NULL
250691,175575,15,27/02/2022,4584016,484448,427855,56593,4099568,N,NULL,9,1/12/2020,NULL
250692,175575,16,27/03/2022,4150812,484448,433204,51245,3666364,N,NULL,9,1/12/2020,NULL
250693,175575,17,27/04/2022,3712193,484448,438619,45830,3227745,N,NULL,9,1/12/2020,NULL
250694,175575,18,27/05/2022,3268092,484448,444101,40347,2783644,N,NULL,9,1/12/2020,NULL
250695,175575,19,27/06/2022,2818439,484448,449653,34796,2333991,N,NULL,9,1/12/2020,NULL
250696,175575,20,27/07/2022,2363166,484448,455273,29175,1878718,N,NULL,9,1/12/2020,NULL
250697,175575,21,27/08/2022,1902202,484448,460964,23484,1417754,N,NULL,9,1/12/2020,NULL
250698,175575,22,27/09/2022,1435476,484448,466726,17722,951028,N,NULL,9,1/12/2020,NULL
250699,175575,23,27/10/2022,962916,484448,472560,11888,478468,N,NULL,9,1/12/2020,NULL
250700,175575,24,27/11/2022,484449,484448,478468,5981,0,N,NULL,9,1/12/2020,NULL
250701,175576,1,27/12/2020,2025000,683402,658402,25000,1341598,N,NULL,9,1/12/2020,NULL
250702,175576,2,27/01/2021,1358368,683402,666632,16770,674966,N,NULL,9,1/12/2020,NULL
250703,175576,3,27/02/2021,683403,683402,674966,8437,0,N,NULL,9,1/12/2020,NULL
250704,175577,1,27/12/2020,10117474,346396,221489,124907,9771078,N,NULL,9,1/12/2020,NULL
250705,175577,2,27/01/2021,9893217,346396,224257,122138,9546821,N,NULL,9,1/12/2020,NULL
250706,175577,3,27/02/2021,9666157,346396,227060,119335,9319761,N,NULL,9,1/12/2020,NULL
250707,175577,4,27/03/2021,9436258,346396,229899,116497,9089862,N,NULL,9,1/12/2020,NULL
250708,175577,5,27/04/2021,9203486,346396,232772,113623,8857090,N,NULL,9,1/12/2020,NULL
250709,175577,6,27/05/2021,8967804,346396,235682,110714,8621408,N,NULL,9,1/12/2020,NULL
250710,175577,7,27/06/2021,8729176,346396,238628,107768,8382780,N,NULL,9,1/12/2020,NULL
250711,175577,8,27/07/2021,8487565,346396,241611,104785,8141169,N,NULL,9,1/12/2020,NULL
250712,175577,9,27/08/2021,8242934,346396,244631,101765,7896538,N,NULL,9,1/12/2020,NULL
250713,175577,10,27/09/2021,7995245,346396,247689,98707,7648849,N,NULL,9,1/12/2020,NULL
250714,175577,11,27/10/2021,7744460,346396,250785,95611,7398064,N,NULL,9,1/12/2020,NULL
250715,175577,12,27/11/2021,7490540,346396,253920,92476,7144144,N,NULL,9,1/12/2020,NULL
250716,175577,13,27/12/2021,7233446,346396,257094,89302,6887050,N,NULL,9,1/12/2020,NULL
250717,175577,14,27/01/2022,6973139,346396,260307,86088,6626743,N,NULL,9,1/12/2020,NULL
250718,175577,15,27/02/2022,6709578,346396,263561,82834,6363182,N,NULL,9,1/12/2020,NULL
250719,175577,16,27/03/2022,6442722,346396,266856,79540,6096326,N,NULL,9,1/12/2020,NULL
250720,175577,17,27/04/2022,6172530,346396,270192,76204,5826134,N,NULL,9,1/12/2020,NULL
250721,175577,18,27/05/2022,5898961,346396,273569,72827,5552565,N,NULL,9,1/12/2020,NULL
250722,175577,19,27/06/2022,5621972,346396,276989,69407,5275576,N,NULL,9,1/12/2020,NULL
250723,175577,20,27/07/2022,5341521,346396,280451,65945,4995125,N,NULL,9,1/12/2020,NULL
250724,175577,21,27/08/2022,5057564,346396,283957,62439,4711168,N,NULL,9,1/12/2020,NULL
250725,175577,22,27/09/2022,4770058,346396,287506,58890,4423662,N,NULL,9,1/12/2020,NULL
250726,175577,23,27/10/2022,4478958,346396,291100,55296,4132562,N,NULL,9,1/12/2020,NULL
250727,175577,24,27/11/2022,4184219,346396,294739,51657,3837823,N,NULL,9,1/12/2020,NULL
250728,175577,25,27/12/2022,3885796,346396,298423,47973,3539400,N,NULL,9,1/12/2020,NULL
250729,175577,26,27/01/2023,3583643,346396,302153,44243,3237247,N,NULL,9,1/12/2020,NULL
250730,175577,27,27/02/2023,3277713,346396,305930,40466,2931317,N,NULL,9,1/12/2020,NULL
250731,175577,28,27/03/2023,2967959,346396,309754,36641,2621563,N,NULL,9,1/12/2020,NULL
250732,175577,29,27/04/2023,2654333,346396,313626,32770,2307937,N,NULL,9,1/12/2020,NULL
250733,175577,30,27/05/2023,2336787,346396,317546,28849,1990391,N,NULL,9,1/12/2020,NULL
250734,175577,31,27/06/2023,2015271,346396,321516,24880,1668875,N,NULL,9,1/12/2020,NULL
250735,175577,32,27/07/2023,1689736,346396,325535,20861,1343340,N,NULL,9,1/12/2020,NULL
250736,175577,33,27/08/2023,1360132,346396,329604,16792,1013736,N,NULL,9,1/12/2020,NULL
250737,175577,34,27/09/2023,1026408,346396,333724,12672,680012,N,NULL,9,1/12/2020,NULL
250738,175577,35,27/10/2023,688513,346396,337895,8500,342117,N,NULL,9,1/12/2020,NULL
250739,175577,36,27/11/2023,346394,346396,342117,4276,0,N,NULL,9,1/12/2020,NULL
250740,175578,1,27/12/2020,2119402,364294,338128,26165,1755108,N,NULL,9,1/12/2020,NULL
250741,175578,2,27/01/2021,1777047,364294,342355,21939,1412753,N,NULL,9,1/12/2020,NULL
250742,175578,3,27/02/2021,1430413,364294,346634,17659,1066119,N,NULL,9,1/12/2020,NULL
250743,175578,4,27/03/2021,1079446,364294,350967,13326,715152,N,NULL,9,1/12/2020,NULL
250744,175578,5,27/04/2021,724092,364294,355354,8939,359798,N,NULL,9,1/12/2020,NULL
250745,175578,6,27/05/2021,364296,364294,359798,4497,0,N,NULL,9,1/12/2020,NULL
250746,175579,1,27/12/2020,4050000,696135,646135,50000,3353865,N,NULL,9,1/12/2020,NULL
250747,175579,2,27/01/2021,3395788,696135,654212,41923,2699653,N,NULL,9,1/12/2020,NULL
250748,175579,3,27/02/2021,2733398,696135,662390,33746,2037263,N,NULL,9,1/12/2020,NULL
250749,175579,4,27/03/2021,2062729,696135,670669,25466,1366594,N,NULL,9,1/12/2020,NULL
250750,175579,5,27/04/2021,1383676,696135,679053,17082,687541,N,NULL,9,1/12/2020,NULL
250751,175579,6,27/05/2021,696135,696135,687541,8594,0,N,NULL,9,1/12/2020,NULL
250752,175580,1,27/12/2020,6049687,896780,822093,74688,5152907,N,NULL,9,1/12/2020,NULL
250753,175580,2,27/01/2021,5217318,896780,832369,64411,4320538,N,NULL,9,1/12/2020,NULL
250754,175580,3,27/02/2021,4374545,896780,842773,54007,3477765,N,NULL,9,1/12/2020,NULL
250755,175580,4,27/03/2021,3521237,896780,853308,43472,2624457,N,NULL,9,1/12/2020,NULL
250756,175580,5,27/04/2021,2657263,896780,863974,32806,1760483,N,NULL,9,1/12/2020,NULL
250757,175580,6,27/05/2021,1782489,896780,874774,22006,885709,N,NULL,9,1/12/2020,NULL
250758,175580,7,27/06/2021,896780,896780,885709,11071,0,N,NULL,9,1/12/2020,NULL
250759,175581,1,27/12/2020,9548862,2431881,2313993,117887,7116981,N,NULL,9,1/12/2020,NULL
250760,175581,2,27/01/2021,7205944,2431881,2342918,88962,4774063,N,NULL,9,1/12/2020,NULL
250761,175581,3,27/02/2021,4833739,2431881,2372205,59676,2401858,N,NULL,9,1/12/2020,NULL
250762,175581,4,27/03/2021,2431882,2431881,2401858,30023,0,N,NULL,9,1/12/2020,NULL
250763,175582,1,27/12/2020,1721250,295857,274607,21250,1425393,N,NULL,9,1/12/2020,NULL
250764,175582,2,27/01/2021,1443210,295857,278040,17817,1147353,N,NULL,9,1/12/2020,NULL
250765,175582,3,27/02/2021,1161694,295857,281516,14342,865837,N,NULL,9,1/12/2020,NULL
250766,175582,4,27/03/2021,876659,295857,285035,10823,580802,N,NULL,9,1/12/2020,NULL
250767,175582,5,27/04/2021,588062,295857,288597,7260,292205,N,NULL,9,1/12/2020,NULL
250768,175582,6,27/05/2021,295857,295857,292205,3653,0,N,NULL,9,1/12/2020,NULL
250769,175583,1,27/12/2020,4050000,1031444,981444,50000,3018556,N,NULL,9,1/12/2020,NULL
250770,175583,2,27/01/2021,3056288,1031444,993712,37732,2024844,N,NULL,9,1/12/2020,NULL
250771,175583,3,27/02/2021,2050154,1031444,1006134,25311,1018710,N,NULL,9,1/12/2020,NULL
250772,175583,4,27/03/2021,1031444,1031444,1018710,12734,0,N,NULL,9,1/12/2020,NULL
250773,175584,1,27/12/2020,3543750,609118,565368,43750,2934632,N,NULL,9,1/12/2020,NULL
250774,175584,2,27/01/2021,2971315,609118,572435,36683,2362197,N,NULL,9,1/12/2020,NULL
250775,175584,3,27/02/2021,2391724,609118,579591,29527,1782606,N,NULL,9,1/12/2020,NULL
250776,175584,4,27/03/2021,1804888,609118,586836,22283,1195770,N,NULL,9,1/12/2020,NULL
250777,175584,5,27/04/2021,1210717,609118,594171,14947,601599,N,NULL,9,1/12/2020,NULL
250778,175584,6,27/05/2021,609119,609118,601599,7520,0,N,NULL,9,1/12/2020,NULL
250779,175585,1,27/12/2020,8100000,387893,287893,100000,7712107,N,NULL,9,1/12/2020,NULL
250780,175585,2,27/01/2021,7808508,387893,291492,96401,7420615,N,NULL,9,1/12/2020,NULL
250781,175585,3,27/02/2021,7513373,387893,295135,92758,7125480,N,NULL,9,1/12/2020,NULL
250782,175585,4,27/03/2021,7214548,387893,298825,89068,6826655,N,NULL,9,1/12/2020,NULL
250783,175585,5,27/04/2021,6911988,387893,302560,85333,6524095,N,NULL,9,1/12/2020,NULL
250784,175585,6,27/05/2021,6605646,387893,306342,81551,6217753,N,NULL,9,1/12/2020,NULL
250785,175585,7,27/06/2021,6295475,387893,310171,77722,5907582,N,NULL,9,1/12/2020,NULL
250786,175585,8,27/07/2021,5981427,387893,314048,73845,5593534,N,NULL,9,1/12/2020,NULL
250787,175585,9,27/08/2021,5663453,387893,317974,69919,5275560,N,NULL,9,1/12/2020,NULL
250788,175585,10,27/09/2021,5341504,387893,321949,65944,4953611,N,NULL,9,1/12/2020,NULL
250789,175585,11,27/10/2021,5015531,387893,325973,61920,4627638,N,NULL,9,1/12/2020,NULL
250790,175585,12,27/11/2021,4685483,387893,330048,57845,4297590,N,NULL,9,1/12/2020,NULL
250791,175585,13,27/12/2021,4351310,387893,334173,53720,3963417,N,NULL,9,1/12/2020,NULL
250792,175585,14,27/01/2022,4012960,387893,338350,49543,3625067,N,NULL,9,1/12/2020,NULL
250793,175585,15,27/02/2022,3670380,387893,342580,45313,3282487,N,NULL,9,1/12/2020,NULL
250794,175585,16,27/03/2022,3323518,387893,346862,41031,2935625,N,NULL,9,1/12/2020,NULL
250795,175585,17,27/04/2022,2972320,387893,351198,36695,2584427,N,NULL,9,1/12/2020,NULL
250796,175585,18,27/05/2022,2616732,387893,355588,32305,2228839,N,NULL,9,1/12/2020,NULL
250797,175585,19,27/06/2022,2256699,387893,360033,27860,1868806,N,NULL,9,1/12/2020,NULL
250798,175585,20,27/07/2022,1892166,387893,364533,23360,1504273,N,NULL,9,1/12/2020,NULL
250799,175585,21,27/08/2022,1523076,387893,369090,18803,1135183,N,NULL,9,1/12/2020,NULL
250800,175585,22,27/09/2022,1149373,387893,373703,14190,761480,N,NULL,9,1/12/2020,NULL
250801,175585,23,27/10/2022,770998,387893,378375,9518,383105,N,NULL,9,1/12/2020,NULL
250802,175585,24,27/11/2022,387894,387893,383105,4789,0,N,NULL,9,1/12/2020,NULL
250803,175586,1,27/12/2020,38339549,1053845,580518,473328,37285704,N,NULL,9,1/12/2020,NULL
250804,175586,2,27/01/2021,37751775,1053845,587774,466071,36697930,N,NULL,9,1/12/2020,NULL
250805,175586,3,27/02/2021,37156654,1053845,595121,458724,36102809,N,NULL,9,1/12/2020,NULL
250806,175586,4,27/03/2021,36554094,1053845,602560,451285,35500249,N,NULL,9,1/12/2020,NULL
250807,175586,5,27/04/2021,35944002,1053845,610092,443753,34890157,N,NULL,9,1/12/2020,NULL
250808,175586,6,27/05/2021,35326284,1053845,617718,436127,34272439,N,NULL,9,1/12/2020,NULL
250809,175586,7,27/06/2021,34700844,1053845,625440,428405,33646999,N,NULL,9,1/12/2020,NULL
250810,175586,8,27/07/2021,34067586,1053845,633258,420587,33013741,N,NULL,9,1/12/2020,NULL
250811,175586,9,27/08/2021,33426412,1053845,641174,412672,32372567,N,NULL,9,1/12/2020,NULL
250812,175586,10,27/09/2021,32777224,1053845,649188,404657,31723379,N,NULL,9,1/12/2020,NULL
250813,175586,11,27/10/2021,32119921,1053845,657303,396542,31066076,N,NULL,9,1/12/2020,NULL
250814,175586,12,27/11/2021,31454402,1053845,665519,388326,30400557,N,NULL,9,1/12/2020,NULL
250815,175586,13,27/12/2021,30780564,1053845,673838,380007,29726719,N,NULL,9,1/12/2020,NULL
250816,175586,14,27/01/2022,30098303,1053845,682261,371584,29044458,N,NULL,9,1/12/2020,NULL
250817,175586,15,27/02/2022,29407513,1053845,690790,363056,28353668,N,NULL,9,1/12/2020,NULL
250818,175586,16,27/03/2022,28708089,1053845,699424,354421,27654244,N,NULL,9,1/12/2020,NULL
250819,175586,17,27/04/2022,27999922,1053845,708167,345678,26946077,N,NULL,9,1/12/2020,NULL
250820,175586,18,27/05/2022,27282903,1053845,717019,336826,26229058,N,NULL,9,1/12/2020,NULL
250821,175586,19,27/06/2022,26556921,1053845,725982,327863,25503076,N,NULL,9,1/12/2020,NULL
250822,175586,20,27/07/2022,25821864,1053845,735057,318788,24768019,N,NULL,9,1/12/2020,NULL
250823,175586,21,27/08/2022,25077619,1053845,744245,309600,24023774,N,NULL,9,1/12/2020,NULL
250824,175586,22,27/09/2022,24324071,1053845,753548,300297,23270226,N,NULL,9,1/12/2020,NULL
250825,175586,23,27/10/2022,23561104,1053845,762967,290878,22507259,N,NULL,9,1/12/2020,NULL
250826,175586,24,27/11/2022,22788599,1053845,772505,281341,21734754,N,NULL,9,1/12/2020,NULL
250827,175586,25,27/12/2022,22006438,1053845,782161,271684,20952593,N,NULL,9,1/12/2020,NULL
250828,175586,26,27/01/2023,21214500,1053845,791938,261907,20160655,N,NULL,9,1/12/2020,NULL
250829,175586,27,27/02/2023,20412663,1053845,801837,252008,19358818,N,NULL,9,1/12/2020,NULL
250830,175586,28,27/03/2023,19600803,1053845,811860,241985,18546958,N,NULL,9,1/12/2020,NULL
250831,175586,29,27/04/2023,18778795,1053845,822008,231837,17724950,N,NULL,9,1/12/2020,NULL
250832,175586,30,27/05/2023,17946512,1053845,832283,221562,16892667,N,NULL,9,1/12/2020,NULL
250833,175586,31,27/06/2023,17103825,1053845,842687,211158,16049980,N,NULL,9,1/12/2020,NULL
250834,175586,32,27/07/2023,16250604,1053845,853221,200625,15196759,N,NULL,9,1/12/2020,NULL
250835,175586,33,27/08/2023,15386718,1053845,863886,189959,14332873,N,NULL,9,1/12/2020,NULL
250836,175586,34,27/09/2023,14512034,1053845,874684,179161,13458189,N,NULL,9,1/12/2020,NULL
250837,175586,35,27/10/2023,13626416,1053845,885618,168227,12572571,N,NULL,9,1/12/2020,NULL
250838,175586,36,27/11/2023,12729728,1053845,896688,157157,11675883,N,NULL,9,1/12/2020,NULL
250839,175586,37,27/12/2023,11821831,1053845,907897,145949,10767986,N,NULL,9,1/12/2020,NULL
250840,175586,38,27/01/2024,10902586,1053845,919245,134600,9848741,N,NULL,9,1/12/2020,NULL
250841,175586,39,27/02/2024,9971850,1053845,930736,123109,8918005,N,NULL,9,1/12/2020,NULL
250842,175586,40,27/03/2024,9029480,1053845,942370,111475,7975635,N,NULL,9,1/12/2020,NULL
250843,175586,41,27/04/2024,8075330,1053845,954150,99695,7021485,N,NULL,9,1/12/2020,NULL
250844,175586,42,27/05/2024,7109253,1053845,966077,87769,6055408,N,NULL,9,1/12/2020,NULL
250845,175586,43,27/06/2024,6131100,1053845,978153,75693,5077255,N,NULL,9,1/12/2020,NULL
250846,175586,44,27/07/2024,5140720,1053845,990380,63466,4086875,N,NULL,9,1/12/2020,NULL
250847,175586,45,27/08/2024,4137961,1053845,1002759,51086,3084116,N,NULL,9,1/12/2020,NULL
250848,175586,46,27/09/2024,3122667,1053845,1015294,38551,2068822,N,NULL,9,1/12/2020,NULL
250849,175586,47,27/10/2024,2094682,1053845,1027985,25860,1040837,N,NULL,9,1/12/2020,NULL
250850,175586,48,27/11/2024,1053847,1053845,1040837,13010,0,N,NULL,9,1/12/2020,NULL
250851,175587,1,27/12/2020,2025000,515722,490722,25000,1509278,N,NULL,9,1/12/2020,NULL
250852,175587,2,27/01/2021,1528144,515722,496856,18866,1012422,N,NULL,9,1/12/2020,NULL
250853,175587,3,27/02/2021,1025077,515722,503067,12655,509355,N,NULL,9,1/12/2020,NULL
250854,175587,4,27/03/2021,515722,515722,509355,6367,0,N,NULL,9,1/12/2020,NULL
250855,175588,1,1/1/2021,8100000,1057065,957065,100000,7042935,N,NULL,9,2/12/2020,NULL
250856,175588,2,1/2/2021,7130972,1057065,969028,88037,6073907,N,NULL,9,2/12/2020,NULL
250857,175588,3,1/3/2021,6149831,1057065,981141,75924,5092766,N,NULL,9,2/12/2020,NULL
250858,175588,4,1/4/2021,5156425,1057065,993406,63660,4099360,N,NULL,9,2/12/2020,NULL
250859,175588,5,1/5/2021,4150602,1057065,1005823,51242,3093537,N,NULL,9,2/12/2020,NULL
250860,175588,6,1/6/2021,3132206,1057065,1018396,38669,2075141,N,NULL,9,2/12/2020,NULL
250861,175588,7,1/7/2021,2101080,1057065,1031126,25939,1044015,N,NULL,9,2/12/2020,NULL
250862,175588,8,1/8/2021,1057065,1057065,1044015,13050,0,N,NULL,9,2/12/2020,NULL
250863,175589,1,1/1/2021,405667,137129,131462,5667,268538,N,NULL,9,2/12/2020,NULL
250864,175589,2,1/2/2021,272342,137129,133325,3804,135213,N,NULL,9,2/12/2020,NULL
250865,175589,3,1/3/2021,137129,137129,135213,1916,0,N,NULL,9,2/12/2020,NULL
250866,175590,1,1/1/2021,19520709,668338,427341,240996,18852371,N,NULL,9,2/12/2020,NULL
250867,175590,2,1/2/2021,19088026,668338,432683,235655,18419688,N,NULL,9,2/12/2020,NULL
250868,175590,3,1/3/2021,18649935,668338,438091,230246,17981597,N,NULL,9,2/12/2020,NULL
250869,175590,4,1/4/2021,18206367,668338,443568,224770,17538029,N,NULL,9,2/12/2020,NULL
250870,175590,5,1/5/2021,17757255,668338,449112,219225,17088917,N,NULL,9,2/12/2020,NULL
250871,175590,6,1/6/2021,17302529,668338,454726,213611,16634191,N,NULL,9,2/12/2020,NULL
250872,175590,7,1/7/2021,16842119,668338,460410,207927,16173781,N,NULL,9,2/12/2020,NULL
250873,175590,8,1/8/2021,16375954,668338,466165,202172,15707616,N,NULL,9,2/12/2020,NULL
250874,175590,9,1/9/2021,15903962,668338,471992,196345,15235624,N,NULL,9,2/12/2020,NULL
250875,175590,10,1/10/2021,15426070,668338,477892,190445,14757732,N,NULL,9,2/12/2020,NULL
250876,175590,11,1/11/2021,14942204,668338,483866,184472,14273866,N,NULL,9,2/12/2020,NULL
250877,175590,12,1/12/2021,14452290,668338,489914,178423,13783952,N,NULL,9,2/12/2020,NULL
250878,175590,13,1/1/2022,13956252,668338,496038,172299,13287914,N,NULL,9,2/12/2020,NULL
250879,175590,14,1/2/2022,13454013,668338,502239,166099,12785675,N,NULL,9,2/12/2020,NULL
250880,175590,15,1/3/2022,12945496,668338,508517,159821,12277158,N,NULL,9,2/12/2020,NULL
250881,175590,16,1/4/2022,12430623,668338,514873,153464,11762285,N,NULL,9,2/12/2020,NULL
250882,175590,17,1/5/2022,11909314,668338,521309,147029,11240976,N,NULL,9,2/12/2020,NULL
250883,175590,18,1/6/2022,11381489,668338,527825,140512,10713151,N,NULL,9,2/12/2020,NULL
250884,175590,19,1/7/2022,10847066,668338,534423,133914,10178728,N,NULL,9,2/12/2020,NULL
250885,175590,20,1/8/2022,10305963,668338,541103,127234,9637625,N,NULL,9,2/12/2020,NULL
250886,175590,21,1/9/2022,9758096,668338,547867,120470,9089758,N,NULL,9,2/12/2020,NULL
250887,175590,22,1/10/2022,9203380,668338,554716,113622,8535042,N,NULL,9,2/12/2020,NULL
250888,175590,23,1/11/2022,8641730,668338,561650,106688,7973392,N,NULL,9,2/12/2020,NULL
250889,175590,24,1/12/2022,8073060,668338,568670,99667,7404722,N,NULL,9,2/12/2020,NULL
250890,175590,25,1/1/2023,7497281,668338,575779,92559,6828943,N,NULL,9,2/12/2020,NULL
250891,175590,26,1/2/2023,6914305,668338,582976,85362,6245967,N,NULL,9,2/12/2020,NULL
250892,175590,27,1/3/2023,6324042,668338,590263,78075,5655704,N,NULL,9,2/12/2020,NULL
250893,175590,28,1/4/2023,5726401,668338,597641,70696,5058063,N,NULL,9,2/12/2020,NULL
250894,175590,29,1/5/2023,5121289,668338,605112,63226,4452951,N,NULL,9,2/12/2020,NULL
250895,175590,30,1/6/2023,4508613,668338,612676,55662,3840275,N,NULL,9,2/12/2020,NULL
250896,175590,31,1/7/2023,3888279,668338,620334,48003,3219941,N,NULL,9,2/12/2020,NULL
250897,175590,32,1/8/2023,3260191,668338,628088,40249,2591853,N,NULL,9,2/12/2020,NULL
250898,175590,33,1/9/2023,2624252,668338,635939,32398,1955914,N,NULL,9,2/12/2020,NULL
250899,175590,34,1/10/2023,1980363,668338,643889,24449,1312025,N,NULL,9,2/12/2020,NULL
250900,175590,35,1/11/2023,1328426,668338,651937,16400,660088,N,NULL,9,2/12/2020,NULL
250901,175590,36,1/12/2023,668340,668338,660088,8251,0,N,NULL,9,2/12/2020,NULL
250902,175591,1,1/1/2021,1518750,386792,368042,18750,1131958,N,NULL,9,2/12/2020,NULL
250903,175591,2,1/2/2021,1146108,386792,372642,14149,759316,N,NULL,9,2/12/2020,NULL
250904,175591,3,1/3/2021,768808,386792,377300,9491,382016,N,NULL,9,2/12/2020,NULL
250905,175591,4,1/4/2021,386792,386792,382016,4775,0,N,NULL,9,2/12/2020,NULL
250906,175592,1,1/1/2021,15187500,1102897,915397,187500,14084603,N,NULL,9,2/12/2020,NULL
250907,175592,2,1/2/2021,14260661,1102897,926839,176058,13157764,N,NULL,9,2/12/2020,NULL
250908,175592,3,1/3/2021,13322236,1102897,938425,164472,12219339,N,NULL,9,2/12/2020,NULL
250909,175592,4,1/4/2021,12372081,1102897,950155,152742,11269184,N,NULL,9,2/12/2020,NULL
250910,175592,5,1/5/2021,11410049,1102897,962032,140865,10307152,N,NULL,9,2/12/2020,NULL
250911,175592,6,1/6/2021,10435991,1102897,974058,128839,9333094,N,NULL,9,2/12/2020,NULL
250912,175592,7,1/7/2021,9449758,1102897,986233,116664,8346861,N,NULL,9,2/12/2020,NULL
250913,175592,8,1/8/2021,8451197,1102897,998561,104336,7348300,N,NULL,9,2/12/2020,NULL
250914,175592,9,1/9/2021,7440154,1102897,1011043,91854,6337257,N,NULL,9,2/12/2020,NULL
250915,175592,10,1/10/2021,6416473,1102897,1023681,79216,5313576,N,NULL,9,2/12/2020,NULL
250916,175592,11,1/11/2021,5379996,1102897,1036477,66420,4277099,N,NULL,9,2/12/2020,NULL
250917,175592,12,1/12/2021,4330563,1102897,1049433,53464,3227666,N,NULL,9,2/12/2020,NULL
250918,175592,13,1/1/2022,3268012,1102897,1062551,40346,2165115,N,NULL,9,2/12/2020,NULL
250919,175592,14,1/2/2022,2192179,1102897,1075833,27064,1089282,N,NULL,9,2/12/2020,NULL
250920,175592,15,1/3/2022,1102898,1102897,1089282,13616,0,N,NULL,9,2/12/2020,NULL
250921,175593,1,1/1/2021,16200000,510743,310743,200000,15689257,N,NULL,9,2/12/2020,NULL
250922,175593,2,1/2/2021,15885373,510743,314627,196116,15374630,N,NULL,9,2/12/2020,NULL
250923,175593,3,1/3/2021,15566813,510743,318560,192183,15056070,N,NULL,9,2/12/2020,NULL
250924,175593,4,1/4/2021,15244271,510743,322542,188201,14733528,N,NULL,9,2/12/2020,NULL
250925,175593,5,1/5/2021,14917697,510743,326574,184169,14406954,N,NULL,9,2/12/2020,NULL
250926,175593,6,1/6/2021,14587041,510743,330656,180087,14076298,N,NULL,9,2/12/2020,NULL
250927,175593,7,1/7/2021,14252252,510743,334789,175954,13741509,N,NULL,9,2/12/2020,NULL
250928,175593,8,1/8/2021,13913278,510743,338974,171769,13402535,N,NULL,9,2/12/2020,NULL
250929,175593,9,1/9/2021,13570067,510743,343211,167532,13059324,N,NULL,9,2/12/2020,NULL
250930,175593,10,1/10/2021,13222566,510743,347501,163242,12711823,N,NULL,9,2/12/2020,NULL
250931,175593,11,1/11/2021,12870721,510743,351845,158898,12359978,N,NULL,9,2/12/2020,NULL
250932,175593,12,1/12/2021,12514478,510743,356243,154500,12003735,N,NULL,9,2/12/2020,NULL
250933,175593,13,1/1/2022,12153782,510743,360696,150047,11643039,N,NULL,9,2/12/2020,NULL
250934,175593,14,1/2/2022,11788577,510743,365205,145538,11277834,N,NULL,9,2/12/2020,NULL
250935,175593,15,1/3/2022,11418807,510743,369770,140973,10908064,N,NULL,9,2/12/2020,NULL
250936,175593,16,1/4/2022,11044415,510743,374392,136351,10533672,N,NULL,9,2/12/2020,NULL
250937,175593,17,1/5/2022,10665343,510743,379072,131671,10154600,N,NULL,9,2/12/2020,NULL
250938,175593,18,1/6/2022,10281533,510743,383810,126933,9770790,N,NULL,9,2/12/2020,NULL
250939,175593,19,1/7/2022,9892925,510743,388608,122135,9382182,N,NULL,9,2/12/2020,NULL
250940,175593,20,1/8/2022,9499460,510743,393465,117277,8988717,N,NULL,9,2/12/2020,NULL
250941,175593,21,1/9/2022,9101076,510743,398384,112359,8590333,N,NULL,9,2/12/2020,NULL
250942,175593,22,1/10/2022,8697713,510743,403363,107379,8186970,N,NULL,9,2/12/2020,NULL
250943,175593,23,1/11/2022,8289308,510743,408405,102337,7778565,N,NULL,9,2/12/2020,NULL
250944,175593,24,1/12/2022,7875797,510743,413511,97232,7365054,N,NULL,9,2/12/2020,NULL
250945,175593,25,1/1/2023,7457118,510743,418679,92063,6946375,N,NULL,9,2/12/2020,NULL
250946,175593,26,1/2/2023,7033205,510743,423913,86830,6522462,N,NULL,9,2/12/2020,NULL
250947,175593,27,1/3/2023,6603993,510743,429212,81531,6093250,N,NULL,9,2/12/2020,NULL
250948,175593,28,1/4/2023,6169416,510743,434577,76166,5658673,N,NULL,9,2/12/2020,NULL
250949,175593,29,1/5/2023,5729407,510743,440009,70733,5218664,N,NULL,9,2/12/2020,NULL
250950,175593,30,1/6/2023,5283898,510743,445509,65233,4773155,N,NULL,9,2/12/2020,NULL
250951,175593,31,1/7/2023,4832820,510743,451078,59664,4322077,N,NULL,9,2/12/2020,NULL
250952,175593,32,1/8/2023,4376103,510743,456717,54026,3865360,N,NULL,9,2/12/2020,NULL
250953,175593,33,1/9/2023,3913677,510743,462426,48317,3402934,N,NULL,9,2/12/2020,NULL
250954,175593,34,1/10/2023,3445471,510743,468206,42537,2934728,N,NULL,9,2/12/2020,NULL
250955,175593,35,1/11/2023,2971413,510743,474058,36684,2460670,N,NULL,9,2/12/2020,NULL
250956,175593,36,1/12/2023,2491429,510743,479984,30758,1980686,N,NULL,9,2/12/2020,NULL
250957,175593,37,1/1/2024,2005445,510743,485984,24759,1494702,N,NULL,9,2/12/2020,NULL
250958,175593,38,1/2/2024,1513386,510743,492059,18684,1002643,N,NULL,9,2/12/2020,NULL
250959,175593,39,1/3/2024,1015176,510743,498210,12533,504433,N,NULL,9,2/12/2020,NULL
250960,175593,40,1/4/2024,510739,510743,504433,6305,0,N,NULL,9,2/12/2020,NULL
250961,175594,1,1/1/2021,4050000,1031444,981444,50000,3018556,N,NULL,9,2/12/2020,NULL
250962,175594,2,1/2/2021,3056288,1031444,993712,37732,2024844,N,NULL,9,2/12/2020,NULL
250963,175594,3,1/3/2021,2050154,1031444,1006134,25311,1018710,N,NULL,9,2/12/2020,NULL
250964,175594,4,1/4/2021,1031444,1031444,1018710,12734,0,N,NULL,9,2/12/2020,NULL
250965,175595,1,1/1/2021,4050000,600355,550355,50000,3449645,N,NULL,9,2/12/2020,NULL
250966,175595,2,1/2/2021,3492766,600355,557234,43121,2892411,N,NULL,9,2/12/2020,NULL
250967,175595,3,1/3/2021,2928566,600355,564200,36155,2328211,N,NULL,9,2/12/2020,NULL
250968,175595,4,1/4/2021,2357314,600355,571252,29103,1756959,N,NULL,9,2/12/2020,NULL
250969,175595,5,1/5/2021,1778921,600355,578393,21962,1178566,N,NULL,9,2/12/2020,NULL
250970,175595,6,1/6/2021,1193298,600355,585623,14732,592943,N,NULL,9,2/12/2020,NULL
250971,175595,7,1/7/2021,600355,600355,592943,7412,0,N,NULL,9,2/12/2020,NULL
250972,175596,1,1/1/2021,10114686,484373,359500,124873,9630313,N,NULL,9,2/12/2020,NULL
250973,175596,2,1/2/2021,9750692,484373,363994,120379,9266319,N,NULL,9,2/12/2020,NULL
250974,175596,3,1/3/2021,9382148,484373,368544,115829,8897775,N,NULL,9,2/12/2020,NULL
250975,175596,4,1/4/2021,9008998,484373,373150,111222,8524625,N,NULL,9,2/12/2020,NULL
250976,175596,5,1/5/2021,8631183,484373,377815,106558,8146810,N,NULL,9,2/12/2020,NULL
250977,175596,6,1/6/2021,8248646,484373,382537,101835,7764273,N,NULL,9,2/12/2020,NULL
250978,175596,7,1/7/2021,7861327,484373,387319,97053,7376954,N,NULL,9,2/12/2020,NULL
250979,175596,8,1/8/2021,7469166,484373,392161,92212,6984793,N,NULL,9,2/12/2020,NULL
250980,175596,9,1/9/2021,7072103,484373,397063,87310,6587730,N,NULL,9,2/12/2020,NULL
250981,175596,10,1/10/2021,6670077,484373,402026,82347,6185704,N,NULL,9,2/12/2020,NULL
250982,175596,11,1/11/2021,6263026,484373,407051,77321,5778653,N,NULL,9,2/12/2020,NULL
250983,175596,12,1/12/2021,5850887,484373,412139,72233,5366514,N,NULL,9,2/12/2020,NULL
250984,175596,13,1/1/2022,5433596,484373,417291,67081,4949223,N,NULL,9,2/12/2020,NULL
250985,175596,14,1/2/2022,5011089,484373,422507,61865,4526716,N,NULL,9,2/12/2020,NULL
250986,175596,15,1/3/2022,4583300,484373,427789,56584,4098927,N,NULL,9,2/12/2020,NULL
250987,175596,16,1/4/2022,4150164,484373,433136,51237,3665791,N,NULL,9,2/12/2020,NULL
250988,175596,17,1/5/2022,3711614,484373,438550,45822,3227241,N,NULL,9,2/12/2020,NULL
250989,175596,18,1/6/2022,3267582,484373,444032,40341,2783209,N,NULL,9,2/12/2020,NULL
250990,175596,19,1/7/2022,2818000,484373,449582,34790,2333627,N,NULL,9,2/12/2020,NULL
250991,175596,20,1/8/2022,2362798,484373,455202,29170,1878425,N,NULL,9,2/12/2020,NULL
250992,175596,21,1/9/2022,1901906,484373,460892,23480,1417533,N,NULL,9,2/12/2020,NULL
250993,175596,22,1/10/2022,1435253,484373,466653,17719,950880,N,NULL,9,2/12/2020,NULL
250994,175596,23,1/11/2022,962766,484373,472487,11886,478393,N,NULL,9,2/12/2020,NULL
250995,175596,24,1/12/2022,484373,484373,478393,5980,0,N,NULL,9,2/12/2020,NULL
250996,165352,1,3/1/2021,39111055,951597,468745,482853,38159458,N,NULL,9,2/12/2020,NULL
250997,165352,2,3/2/2021,38636451,951597,474604,476993,37684854,N,NULL,9,2/12/2020,NULL
250998,165352,3,3/3/2021,38155914,951597,480537,471061,37204317,N,NULL,9,2/12/2020,NULL
250999,165352,4,3/4/2021,37669371,951597,486543,465054,36717774,N,NULL,9,2/12/2020,NULL
251000,165352,5,3/5/2021,37176746,951597,492625,458972,36225149,N,NULL,9,2/12/2020,NULL
251001,165352,6,3/6/2021,36677963,951597,498783,452814,35726366,N,NULL,9,2/12/2020,NULL
251002,165352,7,3/7/2021,36172945,951597,505018,446580,35221348,N,NULL,9,2/12/2020,NULL
251003,165352,8,3/8/2021,35661615,951597,511330,440267,34710018,N,NULL,9,2/12/2020,NULL
251004,165352,9,3/9/2021,35143893,951597,517722,433875,34192296,N,NULL,9,2/12/2020,NULL
251005,165352,10,3/10/2021,34619700,951597,524193,427404,33668103,N,NULL,9,2/12/2020,NULL
251006,165352,11,3/11/2021,34088954,951597,530746,420851,33137357,N,NULL,9,2/12/2020,NULL
251007,165352,12,3/12/2021,33551574,951597,537380,414217,32599977,N,NULL,9,2/12/2020,NULL
251008,165352,13,3/1/2022,33007477,951597,544097,407500,32055880,N,NULL,9,2/12/2020,NULL
251009,165352,14,3/2/2022,32456578,951597,550899,400698,31504981,N,NULL,9,2/12/2020,NULL
251010,165352,15,3/3/2022,31898793,951597,557785,393812,30947196,N,NULL,9,2/12/2020,NULL
251011,165352,16,3/4/2022,31334036,951597,564757,386840,30382439,N,NULL,9,2/12/2020,NULL
251012,165352,17,3/5/2022,30762219,951597,571817,379780,29810622,N,NULL,9,2/12/2020,NULL
251013,165352,18,3/6/2022,30183255,951597,578964,372633,29231658,N,NULL,9,2/12/2020,NULL
251014,165352,19,3/7/2022,29597054,951597,586201,365396,28645457,N,NULL,9,2/12/2020,NULL
251015,165352,20,3/8/2022,29003525,951597,593529,358068,28051928,N,NULL,9,2/12/2020,NULL
251016,165352,21,3/9/2022,28402577,951597,600948,350649,27450980,N,NULL,9,2/12/2020,NULL
251017,165352,22,3/10/2022,27794117,951597,608460,343137,26842520,N,NULL,9,2/12/2020,NULL
251018,165352,23,3/11/2022,27178051,951597,616066,335531,26226454,N,NULL,9,2/12/2020,NULL
251019,165352,24,3/12/2022,26554284,951597,623767,327831,25602687,N,NULL,9,2/12/2020,NULL
251020,165352,25,3/1/2023,25922720,951597,631564,320034,24971123,N,NULL,9,2/12/2020,NULL
251021,165352,26,3/2/2023,25283262,951597,639458,312139,24331665,N,NULL,9,2/12/2020,NULL
251022,165352,27,3/3/2023,24635811,951597,647451,304146,23684214,N,NULL,9,2/12/2020,NULL
251023,165352,28,3/4/2023,23980266,951597,655545,296053,23028669,N,NULL,9,2/12/2020,NULL
251024,165352,29,3/5/2023,23316527,951597,663739,287858,22364930,N,NULL,9,2/12/2020,NULL
251025,165352,30,3/6/2023,22644491,951597,672036,279562,21692894,N,NULL,9,2/12/2020,NULL
251026,165352,31,3/7/2023,21964055,951597,680436,271161,21012458,N,NULL,9,2/12/2020,NULL
251027,165352,32,3/8/2023,21275114,951597,688941,262656,20323517,N,NULL,9,2/12/2020,NULL
251028,165352,33,3/9/2023,20577561,951597,697553,254044,19625964,N,NULL,9,2/12/2020,NULL
251029,165352,34,3/10/2023,19871288,951597,706273,245325,18919691,N,NULL,9,2/12/2020,NULL
251030,165352,35,3/11/2023,19156187,951597,715101,236496,18204590,N,NULL,9,2/12/2020,NULL
251031,165352,36,3/12/2023,18432147,951597,724040,227557,17480550,N,NULL,9,2/12/2020,NULL
251032,165352,37,3/1/2024,17699057,951597,733090,218507,16747460,N,NULL,9,2/12/2020,NULL
251033,165352,38,3/2/2024,16956803,951597,742254,209343,16005206,N,NULL,9,2/12/2020,NULL
251034,165352,39,3/3/2024,16205271,951597,751532,200065,15253674,N,NULL,9,2/12/2020,NULL
251035,165352,40,3/4/2024,15444345,951597,760926,190671,14492748,N,NULL,9,2/12/2020,NULL
251036,165352,41,3/5/2024,14673907,951597,770438,181159,13722310,N,NULL,9,2/12/2020,NULL
251037,165352,42,3/6/2024,13893839,951597,780068,171529,12942242,N,NULL,9,2/12/2020,NULL
251038,165352,43,3/7/2024,13104020,951597,789819,161778,12152423,N,NULL,9,2/12/2020,NULL
251039,165352,44,3/8/2024,12304328,951597,799692,151905,11352731,N,NULL,9,2/12/2020,NULL
251040,165352,45,3/9/2024,11494640,951597,809688,141909,10543043,N,NULL,9,2/12/2020,NULL
251041,165352,46,3/10/2024,10674831,951597,819809,131788,9723234,N,NULL,9,2/12/2020,NULL
251042,165352,47,3/11/2024,9844774,951597,830057,121540,8893177,N,NULL,9,2/12/2020,NULL
251043,165352,48,3/12/2024,9004341,951597,840433,111165,8052744,N,NULL,9,2/12/2020,NULL
251044,165352,49,3/1/2025,8153403,951597,850938,100659,7201806,N,NULL,9,2/12/2020,NULL
251045,165352,50,3/2/2025,7291828,951597,861575,90023,6340231,N,NULL,9,2/12/2020,NULL
251046,165352,51,3/3/2025,6419484,951597,872344,79253,5467887,N,NULL,9,2/12/2020,NULL
251047,165352,52,3/4/2025,5536235,951597,883249,68349,4584638,N,NULL,9,2/12/2020,NULL
251048,165352,53,3/5/2025,4641946,951597,894289,57308,3690349,N,NULL,9,2/12/2020,NULL
251049,165352,54,3/6/2025,3736478,951597,905468,46129,2784881,N,NULL,9,2/12/2020,NULL
251050,165352,55,3/7/2025,2819692,951597,916786,34811,1868095,N,NULL,9,2/12/2020,NULL
251051,165352,56,3/8/2025,1891446,951597,928246,23351,939849,N,NULL,9,2/12/2020,NULL
251052,165352,57,3/9/2025,951597,951597,939849,11748,0,N,NULL,9,2/12/2020,NULL
251053,175597,1,26/12/2020,125532691,2949545,1399758,1549786,122583146,N,NULL,9,3/12/2020,NULL
251054,175597,2,26/01/2021,124115436,2949545,1417255,1532289,121165891,N,NULL,9,3/12/2020,NULL
251055,175597,3,26/02/2021,122680465,2949545,1434971,1514574,119730920,N,NULL,9,3/12/2020,NULL
251056,175597,4,26/03/2021,121227557,2949545,1452908,1496636,118278012,N,NULL,9,3/12/2020,NULL
251057,175597,5,26/04/2021,119756488,2949545,1471069,1478475,116806943,N,NULL,9,3/12/2020,NULL
251058,175597,6,26/05/2021,118267030,2949545,1489458,1460087,115317485,N,NULL,9,3/12/2020,NULL
251059,175597,7,26/06/2021,116758954,2949545,1508076,1441469,113809409,N,NULL,9,3/12/2020,NULL
251060,175597,8,26/07/2021,115232027,2949545,1526927,1422618,112282482,N,NULL,9,3/12/2020,NULL
251061,175597,9,26/08/2021,113686013,2949545,1546014,1403531,110736468,N,NULL,9,3/12/2020,NULL
251062,175597,10,26/09/2021,112120674,2949545,1565339,1384206,109171129,N,NULL,9,3/12/2020,NULL
251063,175597,11,26/10/2021,110535768,2949545,1584906,1364639,107586223,N,NULL,9,3/12/2020,NULL
251064,175597,12,26/11/2021,108931051,2949545,1604717,1344828,105981506,N,NULL,9,3/12/2020,NULL
251065,175597,13,26/12/2021,107306275,2949545,1624776,1324769,104356730,N,NULL,9,3/12/2020,NULL
251066,175597,14,26/01/2022,105661190,2949545,1645085,1304459,102711645,N,NULL,9,3/12/2020,NULL
251067,175597,15,26/02/2022,103995541,2949545,1665649,1283896,101045996,N,NULL,9,3/12/2020,NULL
251068,175597,16,26/03/2022,102309071,2949545,1686470,1263075,99359526,N,NULL,9,3/12/2020,NULL
251069,175597,17,26/04/2022,100601520,2949545,1707551,1241994,97651975,N,NULL,9,3/12/2020,NULL
251070,175597,18,26/05/2022,98872625,2949545,1728895,1220650,95923080,N,NULL,9,3/12/2020,NULL
251071,175597,19,26/06/2022,97122119,2949545,1750506,1199039,94172574,N,NULL,9,3/12/2020,NULL
251072,175597,20,26/07/2022,95349732,2949545,1772387,1177157,92400187,N,NULL,9,3/12/2020,NULL
251073,175597,21,26/08/2022,93555190,2949545,1794542,1155002,90605645,N,NULL,9,3/12/2020,NULL
251074,175597,22,26/09/2022,91738216,2949545,1816974,1132571,88788671,N,NULL,9,3/12/2020,NULL
251075,175597,23,26/10/2022,89898530,2949545,1839686,1109858,86948985,N,NULL,9,3/12/2020,NULL
251076,175597,24,26/11/2022,88035848,2949545,1862682,1086862,85086303,N,NULL,9,3/12/2020,NULL
251077,175597,25,26/12/2022,86149882,2949545,1885966,1063579,83200337,N,NULL,9,3/12/2020,NULL
251078,175597,26,26/01/2023,84240342,2949545,1909540,1040004,81290797,N,NULL,9,3/12/2020,NULL
251079,175597,27,26/02/2023,82306932,2949545,1933410,1016135,79357387,N,NULL,9,3/12/2020,NULL
251080,175597,28,26/03/2023,80349355,2949545,1957577,991967,77399810,N,NULL,9,3/12/2020,NULL
251081,175597,29,26/04/2023,78367308,2949545,1982047,967498,75417763,N,NULL,9,3/12/2020,NULL
251082,175597,30,26/05/2023,76360485,2949545,2006823,942722,73410940,N,NULL,9,3/12/2020,NULL
251083,175597,31,26/06/2023,74328577,2949545,2031908,917637,71379032,N,NULL,9,3/12/2020,NULL
251084,175597,32,26/07/2023,72271270,2949545,2057307,892238,69321725,N,NULL,9,3/12/2020,NULL
251085,175597,33,26/08/2023,70188247,2949545,2083023,866522,67238702,N,NULL,9,3/12/2020,NULL
251086,175597,34,26/09/2023,68079186,2949545,2109061,840484,65129641,N,NULL,9,3/12/2020,NULL
251087,175597,35,26/10/2023,65943762,2949545,2135424,814121,62994217,N,NULL,9,3/12/2020,NULL
251088,175597,36,26/11/2023,63781645,2949545,2162117,787428,60832100,N,NULL,9,3/12/2020,NULL
251089,175597,37,26/12/2023,61592502,2949545,2189143,760401,58642957,N,NULL,9,3/12/2020,NULL
251090,175597,38,26/01/2024,59375994,2949545,2216508,733037,56426449,N,NULL,9,3/12/2020,NULL
251091,175597,39,26/02/2024,57131780,2949545,2244214,705331,54182235,N,NULL,9,3/12/2020,NULL
251092,175597,40,26/03/2024,54859513,2949545,2272267,677278,51909968,N,NULL,9,3/12/2020,NULL
251093,175597,41,26/04/2024,52558843,2949545,2300670,648875,49609298,N,NULL,9,3/12/2020,NULL
251094,175597,42,26/05/2024,50229415,2949545,2329428,620116,47279870,N,NULL,9,3/12/2020,NULL
251095,175597,43,26/06/2024,47870869,2949545,2358546,590998,44921324,N,NULL,9,3/12/2020,NULL
251096,175597,44,26/07/2024,45482841,2949545,2388028,561517,42533296,N,NULL,9,3/12/2020,NULL
251097,175597,45,26/08/2024,43064963,2949545,2417878,531666,40115418,N,NULL,9,3/12/2020,NULL
251098,175597,46,26/09/2024,40616861,2949545,2448102,501443,37667316,N,NULL,9,3/12/2020,NULL
251099,175597,47,26/10/2024,38138158,2949545,2478703,470841,35188613,N,NULL,9,3/12/2020,NULL
251100,175597,48,26/11/2024,35628471,2949545,2509687,439858,32678926,N,NULL,9,3/12/2020,NULL
251101,175597,49,26/12/2024,33087413,2949545,2541058,408487,30137868,N,NULL,9,3/12/2020,NULL
251102,175597,50,26/01/2025,30514592,2949545,2572821,376723,27565047,N,NULL,9,3/12/2020,NULL
251103,175597,51,26/02/2025,27909610,2949545,2604982,344563,24960065,N,NULL,9,3/12/2020,NULL
251104,175597,52,26/03/2025,25272066,2949545,2637544,312001,22322521,N,NULL,9,3/12/2020,NULL
251105,175597,53,26/04/2025,22601553,2949545,2670513,279032,19652008,N,NULL,9,3/12/2020,NULL
251106,175597,54,26/05/2025,19897658,2949545,2703895,245650,16948113,N,NULL,9,3/12/2020,NULL
251107,175597,55,26/06/2025,17159965,2949545,2737693,211851,14210420,N,NULL,9,3/12/2020,NULL
251108,175597,56,26/07/2025,14388051,2949545,2771914,177630,11438506,N,NULL,9,3/12/2020,NULL
251109,175597,57,26/08/2025,11581488,2949545,2806563,142981,8631943,N,NULL,9,3/12/2020,NULL
251110,175597,58,26/09/2025,8739843,2949545,2841645,107899,5790298,N,NULL,9,3/12/2020,NULL
251111,175597,59,26/10/2025,5862677,2949545,2877166,72379,2913132,N,NULL,9,3/12/2020,NULL
251112,175597,60,26/11/2025,2949547,2949545,2913132,36414,0,N,NULL,9,3/12/2020,NULL
251113,175598,1,2/1/2021,10120475,346498,221554,124944,9773977,N,NULL,9,3/12/2020,NULL
251114,175598,2,2/2/2021,9896151,346498,224324,122175,9549653,N,NULL,9,3/12/2020,NULL
251115,175598,3,2/3/2021,9669023,346498,227128,119371,9322525,N,NULL,9,3/12/2020,NULL
251116,175598,4,2/4/2021,9439056,346498,229967,116532,9092558,N,NULL,9,3/12/2020,NULL
251117,175598,5,2/5/2021,9206215,346498,232841,113657,8859717,N,NULL,9,3/12/2020,NULL
251118,175598,6,2/6/2021,8970463,346498,235752,110746,8623965,N,NULL,9,3/12/2020,NULL
251119,175598,7,2/7/2021,8731764,346498,238699,107800,8385266,N,NULL,9,3/12/2020,NULL
251120,175598,8,2/8/2021,8490081,346498,241683,104816,8143583,N,NULL,9,3/12/2020,NULL
251121,175598,9,2/9/2021,8245377,346498,244704,101795,7898879,N,NULL,9,3/12/2020,NULL
251122,175598,10,2/10/2021,7997615,346498,247762,98736,7651117,N,NULL,9,3/12/2020,NULL
251123,175598,11,2/11/2021,7746756,346498,250859,95639,7400258,N,NULL,9,3/12/2020,NULL
251124,175598,12,2/12/2021,7492761,346498,253995,92503,7146263,N,NULL,9,3/12/2020,NULL
251125,175598,13,2/1/2022,7235591,346498,257170,89328,6889093,N,NULL,9,3/12/2020,NULL
251126,175598,14,2/2/2022,6975206,346498,260385,86114,6628708,N,NULL,9,3/12/2020,NULL
251127,175598,15,2/3/2022,6711566,346498,263640,82859,6365068,N,NULL,9,3/12/2020,NULL
251128,175598,16,2/4/2022,6444631,346498,266935,79563,6098133,N,NULL,9,3/12/2020,NULL
251129,175598,17,2/5/2022,6174359,346498,270272,76227,5827861,N,NULL,9,3/12/2020,NULL
251130,175598,18,2/6/2022,5900709,346498,273650,72848,5554211,N,NULL,9,3/12/2020,NULL
251131,175598,19,2/7/2022,5623638,346498,277071,69428,5277140,N,NULL,9,3/12/2020,NULL
251132,175598,20,2/8/2022,5343104,346498,280534,65964,4996606,N,NULL,9,3/12/2020,NULL
251133,175598,21,2/9/2022,5059063,346498,284041,62458,4712565,N,NULL,9,3/12/2020,NULL
251134,175598,22,2/10/2022,4771472,346498,287591,58907,4424974,N,NULL,9,3/12/2020,NULL
251135,175598,23,2/11/2022,4480286,346498,291186,55312,4133788,N,NULL,9,3/12/2020,NULL
251136,175598,24,2/12/2022,4185460,346498,294826,51672,3838962,N,NULL,9,3/12/2020,NULL
251137,175598,25,2/1/2023,3886949,346498,298511,47987,3540451,N,NULL,9,3/12/2020,NULL
251138,175598,26,2/2/2023,3584706,346498,302243,44256,3238208,N,NULL,9,3/12/2020,NULL
251139,175598,27,2/3/2023,3278685,346498,306021,40478,2932187,N,NULL,9,3/12/2020,NULL
251140,175598,28,2/4/2023,2968839,346498,309846,36652,2622341,N,NULL,9,3/12/2020,NULL
251141,175598,29,2/5/2023,2655120,346498,313719,32779,2308622,N,NULL,9,3/12/2020,NULL
251142,175598,30,2/6/2023,2337479,346498,317641,28858,1990981,N,NULL,9,3/12/2020,NULL
251143,175598,31,2/7/2023,2015868,346498,321611,24887,1669370,N,NULL,9,3/12/2020,NULL
251144,175598,32,2/8/2023,1690237,346498,325631,20867,1343739,N,NULL,9,3/12/2020,NULL
251145,175598,33,2/9/2023,1360535,346498,329702,16797,1014037,N,NULL,9,3/12/2020,NULL
251146,175598,34,2/10/2023,1026712,346498,333823,12675,680214,N,NULL,9,3/12/2020,NULL
251147,175598,35,2/11/2023,688716,346498,337996,8503,342218,N,NULL,9,3/12/2020,NULL
251148,175598,36,2/12/2023,346495,346498,342218,4278,0,N,NULL,9,3/12/2020,NULL
251149,175599,1,2/1/2021,6075000,541550,466550,75000,5533450,N,NULL,9,3/12/2020,NULL
251150,175599,2,2/2/2021,5602618,541550,472382,69168,5061068,N,NULL,9,3/12/2020,NULL
251151,175599,3,2/3/2021,5124331,541550,478287,63263,4582781,N,NULL,9,3/12/2020,NULL
251152,175599,4,2/4/2021,4640066,541550,484265,57285,4098516,N,NULL,9,3/12/2020,NULL
251153,175599,5,2/5/2021,4149748,541550,490318,51231,3608198,N,NULL,9,3/12/2020,NULL
251154,175599,6,2/6/2021,3653301,541550,496447,45102,3111751,N,NULL,9,3/12/2020,NULL
251155,175599,7,2/7/2021,3150648,541550,502653,38897,2609098,N,NULL,9,3/12/2020,NULL
251156,175599,8,2/8/2021,2641712,541550,508936,32614,2100162,N,NULL,9,3/12/2020,NULL
251157,175599,9,2/9/2021,2126414,541550,515298,26252,1584864,N,NULL,9,3/12/2020,NULL
251158,175599,10,2/10/2021,1604675,541550,521739,19811,1063125,N,NULL,9,3/12/2020,NULL
251159,175599,11,2/11/2021,1076414,541550,528261,13289,534864,N,NULL,9,3/12/2020,NULL
251160,175599,12,2/12/2021,541550,541550,534864,6686,0,N,NULL,9,3/12/2020,NULL
251161,175600,1,2/1/2021,3037500,622686,585186,37500,2414814,N,NULL,9,3/12/2020,NULL
251162,175600,2,2/2/2021,2444999,622686,592501,30185,1822313,N,NULL,9,3/12/2020,NULL
251163,175600,3,2/3/2021,1845092,622686,599907,22779,1222406,N,NULL,9,3/12/2020,NULL
251164,175600,4,2/4/2021,1237686,622686,607406,15280,615000,N,NULL,9,3/12/2020,NULL
251165,175600,5,2/5/2021,622687,622686,615000,7687,0,N,NULL,9,3/12/2020,NULL
251166,175601,1,2/1/2021,10096255,900021,775375,124645,9196234,N,NULL,9,3/12/2020,NULL
251167,175601,2,2/2/2021,9311187,900021,785068,114953,8411166,N,NULL,9,3/12/2020,NULL
251168,175601,3,2/3/2021,8516306,900021,794881,105140,7616285,N,NULL,9,3/12/2020,NULL
251169,175601,4,2/4/2021,7711489,900021,804817,95204,6811468,N,NULL,9,3/12/2020,NULL
251170,175601,5,2/5/2021,6896612,900021,814877,85143,5996591,N,NULL,9,3/12/2020,NULL
251171,175601,6,2/6/2021,6071549,900021,825063,74957,5171528,N,NULL,9,3/12/2020,NULL
251172,175601,7,2/7/2021,5236172,900021,835377,64644,4336151,N,NULL,9,3/12/2020,NULL
251173,175601,8,2/8/2021,4390353,900021,845819,54202,3490332,N,NULL,9,3/12/2020,NULL
251174,175601,9,2/9/2021,3533962,900021,856391,43629,2633941,N,NULL,9,3/12/2020,NULL
251175,175601,10,2/10/2021,2666866,900021,867096,32924,1766845,N,NULL,9,3/12/2020,NULL
251176,175601,11,2/11/2021,1788931,900021,877935,22086,888910,N,NULL,9,3/12/2020,NULL
251177,175601,12,2/12/2021,900022,900021,888910,11111,0,N,NULL,9,3/12/2020,NULL
251178,175602,1,2/1/2021,2025000,348068,323068,25000,1676932,N,NULL,9,3/12/2020,NULL
251179,175602,2,2/2/2021,1697894,348068,327106,20962,1349826,N,NULL,9,3/12/2020,NULL
251180,175602,3,2/3/2021,1366699,348068,331195,16873,1018631,N,NULL,9,3/12/2020,NULL
251181,175602,4,2/4/2021,1031364,348068,335335,12733,683296,N,NULL,9,3/12/2020,NULL
251182,175602,5,2/5/2021,691838,348068,339526,8541,343770,N,NULL,9,3/12/2020,NULL
251183,175602,6,2/6/2021,348068,348068,343770,4297,0,N,NULL,9,3/12/2020,NULL
251184,175603,1,3/1/2021,6176250,1061606,985356,76250,5114644,N,NULL,9,4/12/2020,NULL
251185,175603,2,3/2/2021,5178577,1061606,997673,63933,4116971,N,NULL,9,4/12/2020,NULL
251186,175603,3,3/3/2021,4168433,1061606,1010144,51462,3106827,N,NULL,9,4/12/2020,NULL
251187,175603,4,3/4/2021,3145662,1061606,1022771,38835,2084056,N,NULL,9,4/12/2020,NULL
251188,175603,5,3/5/2021,2110106,1061606,1035556,26051,1048500,N,NULL,9,4/12/2020,NULL
251189,175603,6,3/6/2021,1061606,1061606,1048500,13106,0,N,NULL,9,4/12/2020,NULL
251190,175604,1,4/1/2021,1518750,512552,493802,18750,1006198,N,NULL,9,7/12/2020,NULL
251191,175604,2,4/2/2021,1018776,512552,499974,12577,506224,N,NULL,9,7/12/2020,NULL
251192,175604,3,4/3/2021,512552,512552,506224,6328,0,N,NULL,9,7/12/2020,NULL
251193,175605,1,4/1/2021,14438250,339244,160994,178250,14099006,N,NULL,9,7/12/2020,NULL
251194,175605,2,4/2/2021,14275243,339244,163007,176238,13935999,N,NULL,9,7/12/2020,NULL
251195,175605,3,4/3/2021,14110199,339244,165044,174200,13770955,N,NULL,9,7/12/2020,NULL
251196,175605,4,4/4/2021,13943092,339244,167107,172137,13603848,N,NULL,9,7/12/2020,NULL
251197,175605,5,4/5/2021,13773896,339244,169196,170048,13434652,N,NULL,9,7/12/2020,NULL
251198,175605,6,4/6/2021,13602585,339244,171311,167933,13263341,N,NULL,9,7/12/2020,NULL
251199,175605,7,4/7/2021,13429132,339244,173453,165792,13089888,N,NULL,9,7/12/2020,NULL
251200,175605,8,4/8/2021,13253511,339244,175621,163624,12914267,N,NULL,9,7/12/2020,NULL
251201,175605,9,4/9/2021,13075695,339244,177816,161428,12736451,N,NULL,9,7/12/2020,NULL
251202,175605,10,4/10/2021,12895656,339244,180039,159206,12556412,N,NULL,9,7/12/2020,NULL
251203,175605,11,4/11/2021,12713367,339244,182289,156955,12374123,N,NULL,9,7/12/2020,NULL
251204,175605,12,4/12/2021,12528799,339244,184568,154677,12189555,N,NULL,9,7/12/2020,NULL
251205,175605,13,4/1/2022,12341924,339244,186875,152369,12002680,N,NULL,9,7/12/2020,NULL
251206,175605,14,4/2/2022,12152713,339244,189211,150033,11813469,N,NULL,9,7/12/2020,NULL
251207,175605,15,4/3/2022,11961137,339244,191576,147668,11621893,N,NULL,9,7/12/2020,NULL
251208,175605,16,4/4/2022,11767166,339244,193971,145274,11427922,N,NULL,9,7/12/2020,NULL
251209,175605,17,4/5/2022,11570771,339244,196395,142849,11231527,N,NULL,9,7/12/2020,NULL
251210,175605,18,4/6/2022,11371921,339244,198850,140394,11032677,N,NULL,9,7/12/2020,NULL
251211,175605,19,4/7/2022,11170585,339244,201336,137908,10831341,N,NULL,9,7/12/2020,NULL
251212,175605,20,4/8/2022,10966732,339244,203853,135392,10627488,N,NULL,9,7/12/2020,NULL
251213,175605,21,4/9/2022,10760331,339244,206401,132844,10421087,N,NULL,9,7/12/2020,NULL
251214,175605,22,4/10/2022,10551350,339244,208981,130264,10212106,N,NULL,9,7/12/2020,NULL
251215,175605,23,4/11/2022,10339757,339244,211593,127651,10000513,N,NULL,9,7/12/2020,NULL
251216,175605,24,4/12/2022,10125519,339244,214238,125006,9786275,N,NULL,9,7/12/2020,NULL
251217,175605,25,4/1/2023,9908603,339244,216916,122328,9569359,N,NULL,9,7/12/2020,NULL
251218,175605,26,4/2/2023,9688976,339244,219627,119617,9349732,N,NULL,9,7/12/2020,NULL
251219,175605,27,4/3/2023,9466603,339244,222373,116872,9127359,N,NULL,9,7/12/2020,NULL
251220,175605,28,4/4/2023,9241451,339244,225152,114092,8902207,N,NULL,9,7/12/2020,NULL
251221,175605,29,4/5/2023,9013484,339244,227967,111278,8674240,N,NULL,9,7/12/2020,NULL
251222,175605,30,4/6/2023,8782668,339244,230816,108428,8443424,N,NULL,9,7/12/2020,NULL
251223,175605,31,4/7/2023,8548966,339244,233702,105543,8209722,N,NULL,9,7/12/2020,NULL
251224,175605,32,4/8/2023,8312343,339244,236623,102622,7973099,N,NULL,9,7/12/2020,NULL
251225,175605,33,4/9/2023,8072762,339244,239581,99664,7733518,N,NULL,9,7/12/2020,NULL
251226,175605,34,4/10/2023,7830187,339244,242575,96669,7490943,N,NULL,9,7/12/2020,NULL
251227,175605,35,4/11/2023,7584579,339244,245608,93637,7245335,N,NULL,9,7/12/2020,NULL
251228,175605,36,4/12/2023,7335901,339244,248678,90567,6996657,N,NULL,9,7/12/2020,NULL
251229,175605,37,4/1/2024,7084115,339244,251786,87458,6744871,N,NULL,9,7/12/2020,NULL
251230,175605,38,4/2/2024,6829181,339244,254934,84311,6489937,N,NULL,9,7/12/2020,NULL
251231,175605,39,4/3/2024,6571061,339244,258120,81124,6231817,N,NULL,9,7/12/2020,NULL
251232,175605,40,4/4/2024,6309714,339244,261347,77898,5970470,N,NULL,9,7/12/2020,NULL
251233,175605,41,4/5/2024,6045100,339244,264614,74631,5705856,N,NULL,9,7/12/2020,NULL
251234,175605,42,4/6/2024,5777179,339244,267921,71323,5437935,N,NULL,9,7/12/2020,NULL
251235,175605,43,4/7/2024,5505909,339244,271270,67974,5166665,N,NULL,9,7/12/2020,NULL
251236,175605,44,4/8/2024,5231248,339244,274661,64583,4892004,N,NULL,9,7/12/2020,NULL
251237,175605,45,4/9/2024,4953154,339244,278094,61150,4613910,N,NULL,9,7/12/2020,NULL
251238,175605,46,4/10/2024,4671583,339244,281571,57674,4332339,N,NULL,9,7/12/2020,NULL
251239,175605,47,4/11/2024,4386493,339244,285090,54154,4047249,N,NULL,9,7/12/2020,NULL
251240,175605,48,4/12/2024,4097839,339244,288654,50591,3758595,N,NULL,9,7/12/2020,NULL
251241,175605,49,4/1/2025,3805577,339244,292262,46982,3466333,N,NULL,9,7/12/2020,NULL
251242,175605,50,4/2/2025,3509662,339244,295915,43329,3170418,N,NULL,9,7/12/2020,NULL
251243,175605,51,4/3/2025,3210048,339244,299614,39630,2870804,N,NULL,9,7/12/2020,NULL
251244,175605,52,4/4/2025,2906689,339244,303359,35885,2567445,N,NULL,9,7/12/2020,NULL
251245,175605,53,4/5/2025,2599538,339244,307151,32093,2260294,N,NULL,9,7/12/2020,NULL
251246,175605,54,4/6/2025,2288547,339244,310991,28254,1949303,N,NULL,9,7/12/2020,NULL
251247,175605,55,4/7/2025,1973669,339244,314878,24366,1634425,N,NULL,9,7/12/2020,NULL
251248,175605,56,4/8/2025,1654855,339244,318814,20430,1315611,N,NULL,9,7/12/2020,NULL
251249,175605,57,4/9/2025,1332056,339244,322799,16445,992812,N,NULL,9,7/12/2020,NULL
251250,175605,58,4/10/2025,1005222,339244,326834,12410,665978,N,NULL,9,7/12/2020,NULL
251251,175605,59,4/11/2025,674302,339244,330920,8325,335058,N,NULL,9,7/12/2020,NULL
251252,175605,60,4/12/2025,339246,339244,335058,4188,0,N,NULL,9,7/12/2020,NULL
251253,175606,1,4/1/2021,40496793,951522,451561,499960,39545271,N,NULL,9,7/12/2020,NULL
251254,175606,2,4/2/2021,40039587,951522,457206,494316,39088065,N,NULL,9,7/12/2020,NULL
251255,175606,3,4/3/2021,39576666,951522,462921,488601,38625144,N,NULL,9,7/12/2020,NULL
251256,175606,4,4/4/2021,39107958,951522,468708,482814,38156436,N,NULL,9,7/12/2020,NULL
251257,175606,5,4/5/2021,38633392,951522,474566,476955,37681870,N,NULL,9,7/12/2020,NULL
251258,175606,6,4/6/2021,38152894,951522,480498,471023,37201372,N,NULL,9,7/12/2020,NULL
251259,175606,7,4/7/2021,37666389,951522,486505,465017,36714867,N,NULL,9,7/12/2020,NULL
251260,175606,8,4/8/2021,37173803,951522,492586,458936,36222281,N,NULL,9,7/12/2020,NULL
251261,175606,9,4/9/2021,36675060,951522,498743,452779,35723538,N,NULL,9,7/12/2020,NULL
251262,175606,10,4/10/2021,36170082,951522,504978,446544,35218560,N,NULL,9,7/12/2020,NULL
251263,175606,11,4/11/2021,35658792,951522,511290,440232,34707270,N,NULL,9,7/12/2020,NULL
251264,175606,12,4/12/2021,35141111,951522,517681,433841,34189589,N,NULL,9,7/12/2020,NULL
251265,175606,13,4/1/2022,34616959,951522,524152,427370,33665437,N,NULL,9,7/12/2020,NULL
251266,175606,14,4/2/2022,34086255,951522,530704,420818,33134733,N,NULL,9,7/12/2020,NULL
251267,175606,15,4/3/2022,33548917,951522,537338,414184,32597395,N,NULL,9,7/12/2020,NULL
251268,175606,16,4/4/2022,33004863,951522,544054,407467,32053341,N,NULL,9,7/12/2020,NULL
251269,175606,17,4/5/2022,32454008,951522,550855,400667,31502486,N,NULL,9,7/12/2020,NULL
251270,175606,18,4/6/2022,31896267,951522,557741,393781,30944745,N,NULL,9,7/12/2020,NULL
251271,175606,19,4/7/2022,31331554,951522,564713,386809,30380032,N,NULL,9,7/12/2020,NULL
251272,175606,20,4/8/2022,30759783,951522,571771,379750,29808261,N,NULL,9,7/12/2020,NULL
251273,175606,21,4/9/2022,30180864,951522,578919,372603,29229342,N,NULL,9,7/12/2020,NULL
251274,175606,22,4/10/2022,29594709,951522,586155,365367,28643187,N,NULL,9,7/12/2020,NULL
251275,175606,23,4/11/2022,29001227,951522,593482,358040,28049705,N,NULL,9,7/12/2020,NULL
251276,175606,24,4/12/2022,28400326,951522,600901,350621,27448804,N,NULL,9,7/12/2020,NULL
251277,175606,25,4/1/2023,27791914,951522,608412,343110,26840392,N,NULL,9,7/12/2020,NULL
251278,175606,26,4/2/2023,27175897,951522,616017,335505,26224375,N,NULL,9,7/12/2020,NULL
251279,175606,27,4/3/2023,26552180,951522,623717,327805,25600658,N,NULL,9,7/12/2020,NULL
251280,175606,28,4/4/2023,25920666,951522,631514,320008,24969144,N,NULL,9,7/12/2020,NULL
251281,175606,29,4/5/2023,25281258,951522,639408,312114,24329736,N,NULL,9,7/12/2020,NULL
251282,175606,30,4/6/2023,24633858,951522,647400,304122,23682336,N,NULL,9,7/12/2020,NULL
251283,175606,31,4/7/2023,23978365,951522,655493,296029,23026843,N,NULL,9,7/12/2020,NULL
251284,175606,32,4/8/2023,23314679,951522,663686,287836,22363157,N,NULL,9,7/12/2020,NULL
251285,175606,33,4/9/2023,22642697,951522,671982,279539,21691175,N,NULL,9,7/12/2020,NULL
251286,175606,34,4/10/2023,21962315,951522,680382,271140,21010793,N,NULL,9,7/12/2020,NULL
251287,175606,35,4/11/2023,21273428,951522,688887,262635,20321906,N,NULL,9,7/12/2020,NULL
251288,175606,36,4/12/2023,20575930,951522,697498,254024,19624408,N,NULL,9,7/12/2020,NULL
251289,175606,37,4/1/2024,19869713,951522,706217,245305,18918191,N,NULL,9,7/12/2020,NULL
251290,175606,38,4/2/2024,19154669,951522,715044,236477,18203147,N,NULL,9,7/12/2020,NULL
251291,175606,39,4/3/2024,18430687,951522,723982,227539,17479165,N,NULL,9,7/12/2020,NULL
251292,175606,40,4/4/2024,17697655,951522,733032,218490,16746133,N,NULL,9,7/12/2020,NULL
251293,175606,41,4/5/2024,16955460,951522,742195,209327,16003938,N,NULL,9,7/12/2020,NULL
251294,175606,42,4/6/2024,16203987,951522,751473,200049,15252465,N,NULL,9,7/12/2020,NULL
251295,175606,43,4/7/2024,15443121,951522,760866,190656,14491599,N,NULL,9,7/12/2020,NULL
251296,175606,44,4/8/2024,14672744,951522,770377,181145,13721222,N,NULL,9,7/12/2020,NULL
251297,175606,45,4/9/2024,13892737,951522,780007,171515,12941215,N,NULL,9,7/12/2020,NULL
251298,175606,46,4/10/2024,13102980,951522,789757,161765,12151458,N,NULL,9,7/12/2020,NULL
251299,175606,47,4/11/2024,12303351,951522,799629,151893,11351829,N,NULL,9,7/12/2020,NULL
251300,175606,48,4/12/2024,11493727,951522,809624,141898,10542205,N,NULL,9,7/12/2020,NULL
251301,175606,49,4/1/2025,10673983,951522,819744,131778,9722461,N,NULL,9,7/12/2020,NULL
251302,175606,50,4/2/2025,9843992,951522,829991,121531,8892470,N,NULL,9,7/12/2020,NULL
251303,175606,51,4/3/2025,9003626,951522,840366,111156,8052104,N,NULL,9,7/12/2020,NULL
251304,175606,52,4/4/2025,8152755,951522,850871,100651,7201233,N,NULL,9,7/12/2020,NULL
251305,175606,53,4/5/2025,7291249,951522,861506,90015,6339727,N,NULL,9,7/12/2020,NULL
251306,175606,54,4/6/2025,6418974,951522,872275,79247,5467452,N,NULL,9,7/12/2020,NULL
251307,175606,55,4/7/2025,5535795,951522,883179,68343,4584273,N,NULL,9,7/12/2020,NULL
251308,175606,56,4/8/2025,4641577,951522,894218,57303,3690055,N,NULL,9,7/12/2020,NULL
251309,175606,57,4/9/2025,3736181,951522,905396,46126,2784659,N,NULL,9,7/12/2020,NULL
251310,175606,58,4/10/2025,2819467,951522,916714,34808,1867945,N,NULL,9,7/12/2020,NULL
251311,175606,59,4/11/2025,1891295,951522,928172,23349,939773,N,NULL,9,7/12/2020,NULL
251312,175606,60,4/12/2025,951520,951522,939773,11747,0,N,NULL,9,7/12/2020,NULL
251313,175607,1,4/1/2021,4646053,952439,895081,57359,3693614,N,NULL,9,7/12/2020,NULL
251314,175607,2,4/2/2021,3739784,952439,906269,46170,2787345,N,NULL,9,7/12/2020,NULL
251315,175607,3,4/3/2021,2822187,952439,917597,34842,1869748,N,NULL,9,7/12/2020,NULL
251316,175607,4,4/4/2021,1893120,952439,929067,23372,940681,N,NULL,9,7/12/2020,NULL
251317,175607,5,4/5/2021,952439,952439,940681,11759,0,N,NULL,9,7/12/2020,NULL
251318,175608,1,4/1/2021,7606380,1559305,1465399,93906,6047075,N,NULL,9,7/12/2020,NULL
251319,175608,2,4/2/2021,6122663,1559305,1483717,75588,4563358,N,NULL,9,7/12/2020,NULL
251320,175608,3,4/3/2021,4620400,1559305,1502263,57042,3061095,N,NULL,9,7/12/2020,NULL
251321,175608,4,4/4/2021,3099359,1559305,1521041,38264,1540054,N,NULL,9,7/12/2020,NULL
251322,175608,5,4/5/2021,1559305,1559305,1540054,19251,0,N,NULL,9,7/12/2020,NULL
251323,175609,1,4/1/2021,2025000,348068,323068,25000,1676932,N,NULL,9,7/12/2020,NULL
251324,175609,2,4/2/2021,1697894,348068,327106,20962,1349826,N,NULL,9,7/12/2020,NULL
251325,175609,3,4/3/2021,1366699,348068,331195,16873,1018631,N,NULL,9,7/12/2020,NULL
251326,175609,4,4/4/2021,1031364,348068,335335,12733,683296,N,NULL,9,7/12/2020,NULL
251327,175609,5,4/5/2021,691838,348068,339526,8541,343770,N,NULL,9,7/12/2020,NULL
251328,175609,6,4/6/2021,348068,348068,343770,4297,0,N,NULL,9,7/12/2020,NULL
251329,175610,1,4/1/2021,1012500,341701,329201,12500,670799,N,NULL,9,7/12/2020,NULL
251330,175610,2,4/2/2021,679184,341701,333316,8385,337483,N,NULL,9,7/12/2020,NULL
251331,175610,3,4/3/2021,341701,341701,337483,4219,0,N,NULL,9,7/12/2020,NULL
251332,175611,1,4/1/2021,7750922,1148964,1053273,95690,6601958,N,NULL,9,7/12/2020,NULL
251333,175611,2,4/2/2021,6684483,1148964,1066439,82524,5535519,N,NULL,9,7/12/2020,NULL
251334,175611,3,4/3/2021,5604713,1148964,1079770,69194,4455749,N,NULL,9,7/12/2020,NULL
251335,175611,4,4/4/2021,4511446,1148964,1093267,55697,3362482,N,NULL,9,7/12/2020,NULL
251336,175611,5,4/5/2021,3404513,1148964,1106933,42031,2255549,N,NULL,9,7/12/2020,NULL
251337,175611,6,4/6/2021,2283744,1148964,1120769,28194,1134780,N,NULL,9,7/12/2020,NULL
251338,175611,7,4/7/2021,1148965,1148964,1134780,14185,0,N,NULL,9,7/12/2020,NULL
251339,175612,1,4/1/2021,10125000,346653,221653,125000,9778347,N,NULL,9,7/12/2020,NULL
251340,175612,2,4/2/2021,9900576,346653,224424,122229,9553923,N,NULL,9,7/12/2020,NULL
251341,175612,3,4/3/2021,9673347,346653,227229,119424,9326694,N,NULL,9,7/12/2020,NULL
251342,175612,4,4/4/2021,9443277,346653,230070,116584,9096624,N,NULL,9,7/12/2020,NULL
251343,175612,5,4/5/2021,9210332,346653,232945,113708,8863679,N,NULL,9,7/12/2020,NULL
251344,175612,6,4/6/2021,8974475,346653,235857,110796,8627822,N,NULL,9,7/12/2020,NULL
251345,175612,7,4/7/2021,8735669,346653,238806,107848,8389016,N,NULL,9,7/12/2020,NULL
251346,175612,8,4/8/2021,8493878,346653,241791,104863,8147225,N,NULL,9,7/12/2020,NULL
251347,175612,9,4/9/2021,8249065,346653,244813,101840,7902412,N,NULL,9,7/12/2020,NULL
251348,175612,10,4/10/2021,8001192,346653,247873,98780,7654539,N,NULL,9,7/12/2020,NULL
251349,175612,11,4/11/2021,7750220,346653,250972,95682,7403567,N,NULL,9,7/12/2020,NULL
251350,175612,12,4/12/2021,7496111,346653,254109,92545,7149458,N,NULL,9,7/12/2020,NULL
251351,175612,13,4/1/2022,7238826,346653,257285,89368,6892173,N,NULL,9,7/12/2020,NULL
251352,175612,14,4/2/2022,6978325,346653,260501,86152,6631672,N,NULL,9,7/12/2020,NULL
251353,175612,15,4/3/2022,6714568,346653,263757,82896,6367915,N,NULL,9,7/12/2020,NULL
251354,175612,16,4/4/2022,6447514,346653,267054,79599,6100861,N,NULL,9,7/12/2020,NULL
251355,175612,17,4/5/2022,6177121,346653,270393,76261,5830468,N,NULL,9,7/12/2020,NULL
251356,175612,18,4/6/2022,5903349,346653,273772,72881,5556696,N,NULL,9,7/12/2020,NULL
251357,175612,19,4/7/2022,5626154,346653,277195,69459,5279501,N,NULL,9,7/12/2020,NULL
251358,175612,20,4/8/2022,5345494,346653,280660,65994,4998841,N,NULL,9,7/12/2020,NULL
251359,175612,21,4/9/2022,5061326,346653,284168,62486,4714673,N,NULL,9,7/12/2020,NULL
251360,175612,22,4/10/2022,4773606,346653,287720,58933,4426953,N,NULL,9,7/12/2020,NULL
251361,175612,23,4/11/2022,4482290,346653,291316,55337,4135637,N,NULL,9,7/12/2020,NULL
251362,175612,24,4/12/2022,4187332,346653,294958,51695,3840679,N,NULL,9,7/12/2020,NULL
251363,175612,25,4/1/2023,3888687,346653,298645,48008,3542034,N,NULL,9,7/12/2020,NULL
251364,175612,26,4/2/2023,3586309,346653,302378,44275,3239656,N,NULL,9,7/12/2020,NULL
251365,175612,27,4/3/2023,3280151,346653,306158,40496,2933498,N,NULL,9,7/12/2020,NULL
251366,175612,28,4/4/2023,2970166,346653,309985,36669,2623513,N,NULL,9,7/12/2020,NULL
251367,175612,29,4/5/2023,2656307,346653,313859,32794,2309654,N,NULL,9,7/12/2020,NULL
251368,175612,30,4/6/2023,2338524,346653,317783,28871,1991871,N,NULL,9,7/12/2020,NULL
251369,175612,31,4/7/2023,2016769,346653,321755,24898,1670116,N,NULL,9,7/12/2020,NULL
251370,175612,32,4/8/2023,1690992,346653,325777,20876,1344339,N,NULL,9,7/12/2020,NULL
251371,175612,33,4/9/2023,1361143,346653,329849,16804,1014490,N,NULL,9,7/12/2020,NULL
251372,175612,34,4/10/2023,1027171,346653,333972,12681,680518,N,NULL,9,7/12/2020,NULL
251373,175612,35,4/11/2023,689024,346653,338147,8507,342371,N,NULL,9,7/12/2020,NULL
251374,175612,36,4/12/2023,346650,346653,342371,4280,0,N,NULL,9,7/12/2020,NULL
251375,175613,1,7/1/2021,10125000,346653,221653,125000,9778347,N,NULL,9,8/12/2020,NULL
251376,175613,2,7/2/2021,9900576,346653,224424,122229,9553923,N,NULL,9,8/12/2020,NULL
251377,175613,3,7/3/2021,9673347,346653,227229,119424,9326694,N,NULL,9,8/12/2020,NULL
251378,175613,4,7/4/2021,9443277,346653,230070,116584,9096624,N,NULL,9,8/12/2020,NULL
251379,175613,5,7/5/2021,9210332,346653,232945,113708,8863679,N,NULL,9,8/12/2020,NULL
251380,175613,6,7/6/2021,8974475,346653,235857,110796,8627822,N,NULL,9,8/12/2020,NULL
251381,175613,7,7/7/2021,8735669,346653,238806,107848,8389016,N,NULL,9,8/12/2020,NULL
251382,175613,8,7/8/2021,8493878,346653,241791,104863,8147225,N,NULL,9,8/12/2020,NULL
251383,175613,9,7/9/2021,8249065,346653,244813,101840,7902412,N,NULL,9,8/12/2020,NULL
251384,175613,10,7/10/2021,8001192,346653,247873,98780,7654539,N,NULL,9,8/12/2020,NULL
251385,175613,11,7/11/2021,7750220,346653,250972,95682,7403567,N,NULL,9,8/12/2020,NULL
251386,175613,12,7/12/2021,7496111,346653,254109,92545,7149458,N,NULL,9,8/12/2020,NULL
251387,175613,13,7/1/2022,7238826,346653,257285,89368,6892173,N,NULL,9,8/12/2020,NULL
251388,175613,14,7/2/2022,6978325,346653,260501,86152,6631672,N,NULL,9,8/12/2020,NULL
251389,175613,15,7/3/2022,6714568,346653,263757,82896,6367915,N,NULL,9,8/12/2020,NULL
251390,175613,16,7/4/2022,6447514,346653,267054,79599,6100861,N,NULL,9,8/12/2020,NULL
251391,175613,17,7/5/2022,6177121,346653,270393,76261,5830468,N,NULL,9,8/12/2020,NULL
251392,175613,18,7/6/2022,5903349,346653,273772,72881,5556696,N,NULL,9,8/12/2020,NULL
251393,175613,19,7/7/2022,5626154,346653,277195,69459,5279501,N,NULL,9,8/12/2020,NULL
251394,175613,20,7/8/2022,5345494,346653,280660,65994,4998841,N,NULL,9,8/12/2020,NULL
251395,175613,21,7/9/2022,5061326,346653,284168,62486,4714673,N,NULL,9,8/12/2020,NULL
251396,175613,22,7/10/2022,4773606,346653,287720,58933,4426953,N,NULL,9,8/12/2020,NULL
251397,175613,23,7/11/2022,4482290,346653,291316,55337,4135637,N,NULL,9,8/12/2020,NULL
251398,175613,24,7/12/2022,4187332,346653,294958,51695,3840679,N,NULL,9,8/12/2020,NULL
251399,175613,25,7/1/2023,3888687,346653,298645,48008,3542034,N,NULL,9,8/12/2020,NULL
251400,175613,26,7/2/2023,3586309,346653,302378,44275,3239656,N,NULL,9,8/12/2020,NULL
251401,175613,27,7/3/2023,3280151,346653,306158,40496,2933498,N,NULL,9,8/12/2020,NULL
251402,175613,28,7/4/2023,2970166,346653,309985,36669,2623513,N,NULL,9,8/12/2020,NULL
251403,175613,29,7/5/2023,2656307,346653,313859,32794,2309654,N,NULL,9,8/12/2020,NULL
251404,175613,30,7/6/2023,2338524,346653,317783,28871,1991871,N,NULL,9,8/12/2020,NULL
251405,175613,31,7/7/2023,2016769,346653,321755,24898,1670116,N,NULL,9,8/12/2020,NULL
251406,175613,32,7/8/2023,1690992,346653,325777,20876,1344339,N,NULL,9,8/12/2020,NULL
251407,175613,33,7/9/2023,1361143,346653,329849,16804,1014490,N,NULL,9,8/12/2020,NULL
251408,175613,34,7/10/2023,1027171,346653,333972,12681,680518,N,NULL,9,8/12/2020,NULL
251409,175613,35,7/11/2023,689024,346653,338147,8507,342371,N,NULL,9,8/12/2020,NULL
251410,175613,36,7/12/2023,346650,346653,342371,4280,0,N,NULL,9,8/12/2020,NULL
251411,175614,1,8/1/2021,6427853,952838,873482,79356,5475015,N,NULL,9,10/12/2020,NULL
251412,175614,2,8/2/2021,5543453,952838,884400,68438,4590615,N,NULL,9,10/12/2020,NULL
251413,175614,3,8/3/2021,4647998,952838,895455,57383,3695160,N,NULL,9,10/12/2020,NULL
251414,175614,4,8/4/2021,3741350,952838,906648,46190,2788512,N,NULL,9,10/12/2020,NULL
251415,175614,5,8/5/2021,2823369,952838,917981,34856,1870531,N,NULL,9,10/12/2020,NULL
251416,175614,6,8/6/2021,1893913,952838,929456,23382,941075,N,NULL,9,10/12/2020,NULL
251417,175614,7,8/7/2021,952839,952838,941075,11763,0,N,NULL,9,10/12/2020,NULL
251418,175615,1,9/1/2021,7200098,246512,157622,88890,6953586,N,NULL,9,10/12/2020,NULL
251419,175615,2,9/2/2021,7040505,246512,159593,86920,6793993,N,NULL,9,10/12/2020,NULL
251420,175615,3,9/3/2021,6878918,246512,161587,84925,6632406,N,NULL,9,10/12/2020,NULL
251421,175615,4,9/4/2021,6715311,246512,163607,82905,6468799,N,NULL,9,10/12/2020,NULL
251422,175615,5,9/5/2021,6549659,246512,165652,80860,6303147,N,NULL,9,10/12/2020,NULL
251423,175615,6,9/6/2021,6381936,246512,167723,78789,6135424,N,NULL,9,10/12/2020,NULL
251424,175615,7,9/7/2021,6212116,246512,169820,76693,5965604,N,NULL,9,10/12/2020,NULL
251425,175615,8,9/8/2021,6040174,246512,171942,74570,5793662,N,NULL,9,10/12/2020,NULL
251426,175615,9,9/9/2021,5866082,246512,174092,72421,5619570,N,NULL,9,10/12/2020,NULL
251427,175615,10,9/10/2021,5689814,246512,176268,70245,5443302,N,NULL,9,10/12/2020,NULL
251428,175615,11,9/11/2021,5511343,246512,178471,68041,5264831,N,NULL,9,10/12/2020,NULL
251429,175615,12,9/12/2021,5330641,246512,180702,65810,5084129,N,NULL,9,10/12/2020,NULL
251430,175615,13,9/1/2022,5147680,246512,182961,63552,4901168,N,NULL,9,10/12/2020,NULL
251431,175615,14,9/2/2022,4962432,246512,185248,61265,4715920,N,NULL,9,10/12/2020,NULL
251432,175615,15,9/3/2022,4774869,246512,187563,58949,4528357,N,NULL,9,10/12/2020,NULL
251433,175615,16,9/4/2022,4584961,246512,189908,56604,4338449,N,NULL,9,10/12/2020,NULL
251434,175615,17,9/5/2022,4392679,246512,192282,54231,4146167,N,NULL,9,10/12/2020,NULL
251435,175615,18,9/6/2022,4197994,246512,194685,51827,3951482,N,NULL,9,10/12/2020,NULL
251436,175615,19,9/7/2022,4000875,246512,197119,49394,3754363,N,NULL,9,10/12/2020,NULL
251437,175615,20,9/8/2022,3801292,246512,199583,46930,3554780,N,NULL,9,10/12/2020,NULL
251438,175615,21,9/9/2022,3599214,246512,202078,44435,3352702,N,NULL,9,10/12/2020,NULL
251439,175615,22,9/10/2022,3394610,246512,204604,41909,3148098,N,NULL,9,10/12/2020,NULL
251440,175615,23,9/11/2022,3187449,246512,207161,39351,2940937,N,NULL,9,10/12/2020,NULL
251441,175615,24,9/12/2022,2977698,246512,209751,36762,2731186,N,NULL,9,10/12/2020,NULL
251442,175615,25,9/1/2023,2765325,246512,212373,34140,2518813,N,NULL,9,10/12/2020,NULL
251443,175615,26,9/2/2023,2550298,246512,215027,31485,2303786,N,NULL,9,10/12/2020,NULL
251444,175615,27,9/3/2023,2332583,246512,217715,28797,2086071,N,NULL,9,10/12/2020,NULL
251445,175615,28,9/4/2023,2112147,246512,220436,26076,1865635,N,NULL,9,10/12/2020,NULL
251446,175615,29,9/5/2023,1888955,246512,223192,23320,1642443,N,NULL,9,10/12/2020,NULL
251447,175615,30,9/6/2023,1662973,246512,225982,20531,1416461,N,NULL,9,10/12/2020,NULL
251448,175615,31,9/7/2023,1434166,246512,228807,17706,1187654,N,NULL,9,10/12/2020,NULL
251449,175615,32,9/8/2023,1202499,246512,231667,14846,955987,N,NULL,9,10/12/2020,NULL
251450,175615,33,9/9/2023,967937,246512,234562,11950,721425,N,NULL,9,10/12/2020,NULL
251451,175615,34,9/10/2023,730442,246512,237495,9018,483930,N,NULL,9,10/12/2020,NULL
251452,175615,35,9/11/2023,489979,246512,240463,6049,243467,N,NULL,9,10/12/2020,NULL
251453,175615,36,9/12/2023,246510,246512,243467,3043,0,N,NULL,9,10/12/2020,NULL
251454,175616,1,9/1/2021,34425000,1178621,753621,425000,33246379,N,NULL,9,10/12/2020,NULL
251455,175616,2,9/2/2021,33661959,1178621,763041,415580,32483338,N,NULL,9,10/12/2020,NULL
251456,175616,3,9/3/2021,32889380,1178621,772579,406042,31710759,N,NULL,9,10/12/2020,NULL
251457,175616,4,9/4/2021,32107143,1178621,782237,396384,30928522,N,NULL,9,10/12/2020,NULL
251458,175616,5,9/5/2021,31315128,1178621,792015,386607,30136507,N,NULL,9,10/12/2020,NULL
251459,175616,6,9/6/2021,30513213,1178621,801915,376706,29334592,N,NULL,9,10/12/2020,NULL
251460,175616,7,9/7/2021,29701274,1178621,811939,366682,28522653,N,NULL,9,10/12/2020,NULL
251461,175616,8,9/8/2021,28879186,1178621,822088,356533,27700565,N,NULL,9,10/12/2020,NULL
251462,175616,9,9/9/2021,28046822,1178621,832364,346257,26868201,N,NULL,9,10/12/2020,NULL
251463,175616,10,9/10/2021,27204053,1178621,842769,335853,26025432,N,NULL,9,10/12/2020,NULL
251464,175616,11,9/11/2021,26350750,1178621,853303,325318,25172129,N,NULL,9,10/12/2020,NULL
251465,175616,12,9/12/2021,25486780,1178621,863970,314652,24308159,N,NULL,9,10/12/2020,NULL
251466,175616,13,9/1/2022,24612011,1178621,874769,303852,23433390,N,NULL,9,10/12/2020,NULL
251467,175616,14,9/2/2022,23726307,1178621,885704,292917,22547686,N,NULL,9,10/12/2020,NULL
251468,175616,15,9/3/2022,22829532,1178621,896775,281846,21650911,N,NULL,9,10/12/2020,NULL
251469,175616,16,9/4/2022,21921547,1178621,907985,270636,20742926,N,NULL,9,10/12/2020,NULL
251470,175616,17,9/5/2022,21002212,1178621,919335,259287,19823591,N,NULL,9,10/12/2020,NULL
251471,175616,18,9/6/2022,20071386,1178621,930826,247795,18892765,N,NULL,9,10/12/2020,NULL
251472,175616,19,9/7/2022,19128924,1178621,942462,236160,17950303,N,NULL,9,10/12/2020,NULL
251473,175616,20,9/8/2022,18174682,1178621,954242,224379,16996061,N,NULL,9,10/12/2020,NULL
251474,175616,21,9/9/2022,17208512,1178621,966170,212451,16029891,N,NULL,9,10/12/2020,NULL
251475,175616,22,9/10/2022,16230264,1178621,978248,200374,15051643,N,NULL,9,10/12/2020,NULL
251476,175616,23,9/11/2022,15239788,1178621,990476,188146,14061167,N,NULL,9,10/12/2020,NULL
251477,175616,24,9/12/2022,14236931,1178621,1002857,175765,13058310,N,NULL,9,10/12/2020,NULL
251478,175616,25,9/1/2023,13221539,1178621,1015392,163229,12042918,N,NULL,9,10/12/2020,NULL
251479,175616,26,9/2/2023,12193454,1178621,1028085,150536,11014833,N,NULL,9,10/12/2020,NULL
251480,175616,27,9/3/2023,11152518,1178621,1040936,137685,9973897,N,NULL,9,10/12/2020,NULL
251481,175616,28,9/4/2023,10098571,1178621,1053947,124674,8919950,N,NULL,9,10/12/2020,NULL
251482,175616,29,9/5/2023,9031449,1178621,1067122,111499,7852828,N,NULL,9,10/12/2020,NULL
251483,175616,30,9/6/2023,7950988,1178621,1080461,98160,6772367,N,NULL,9,10/12/2020,NULL
251484,175616,31,9/7/2023,6857021,1178621,1093967,84655,5678400,N,NULL,9,10/12/2020,NULL
251485,175616,32,9/8/2023,5749380,1178621,1107641,70980,4570759,N,NULL,9,10/12/2020,NULL
251486,175616,33,9/9/2023,4627893,1178621,1121487,57135,3449272,N,NULL,9,10/12/2020,NULL
251487,175616,34,9/10/2023,3492388,1178621,1135505,43116,2313767,N,NULL,9,10/12/2020,NULL
251488,175616,35,9/11/2023,2342689,1178621,1149699,28922,1164068,N,NULL,9,10/12/2020,NULL
251489,175616,36,9/12/2023,1178619,1178621,1164068,14551,0,N,NULL,9,10/12/2020,NULL
251490,175617,1,9/1/2021,1923750,171491,147741,23750,1752259,N,NULL,9,10/12/2020,NULL
251491,175617,2,9/2/2021,1774162,171491,149588,21903,1602671,N,NULL,9,10/12/2020,NULL
251492,175617,3,9/3/2021,1622705,171491,151457,20033,1451214,N,NULL,9,10/12/2020,NULL
251493,175617,4,9/4/2021,1469354,171491,153351,18140,1297863,N,NULL,9,10/12/2020,NULL
251494,175617,5,9/5/2021,1314087,171491,155267,16223,1142596,N,NULL,9,10/12/2020,NULL
251495,175617,6,9/6/2021,1156879,171491,157208,14282,985388,N,NULL,9,10/12/2020,NULL
251496,175617,7,9/7/2021,997706,171491,159173,12317,826215,N,NULL,9,10/12/2020,NULL
251497,175617,8,9/8/2021,836543,171491,161163,10328,665052,N,NULL,9,10/12/2020,NULL
251498,175617,9,9/9/2021,673365,171491,163178,8313,501874,N,NULL,9,10/12/2020,NULL
251499,175617,10,9/10/2021,508148,171491,165217,6273,336657,N,NULL,9,10/12/2020,NULL
251500,175617,11,9/11/2021,340865,171491,167283,4208,169374,N,NULL,9,10/12/2020,NULL
251501,175617,12,9/12/2021,171491,171491,169374,2117,0,N,NULL,9,10/12/2020,NULL
251502,175618,1,9/1/2021,10125000,902583,777583,125000,9222417,N,NULL,9,10/12/2020,NULL
251503,175618,2,9/2/2021,9337697,902583,787303,115280,8435114,N,NULL,9,10/12/2020,NULL
251504,175618,3,9/3/2021,8540553,902583,797144,105439,7637970,N,NULL,9,10/12/2020,NULL
251505,175618,4,9/4/2021,7733444,902583,807109,95475,6830861,N,NULL,9,10/12/2020,NULL
251506,175618,5,9/5/2021,6916247,902583,817197,85386,6013664,N,NULL,9,10/12/2020,NULL
251507,175618,6,9/6/2021,6088835,902583,827412,75171,5186252,N,NULL,9,10/12/2020,NULL
251508,175618,7,9/7/2021,5251080,902583,837755,64828,4348497,N,NULL,9,10/12/2020,NULL
251509,175618,8,9/8/2021,4402853,902583,848227,54356,3500270,N,NULL,9,10/12/2020,NULL
251510,175618,9,9/9/2021,3544023,902583,858830,43753,2641440,N,NULL,9,10/12/2020,NULL
251511,175618,10,9/10/2021,2674458,902583,869565,33018,1771875,N,NULL,9,10/12/2020,NULL
251512,175618,11,9/11/2021,1794023,902583,880435,22148,891440,N,NULL,9,10/12/2020,NULL
251513,175618,12,9/12/2021,902583,902583,891440,11143,0,N,NULL,9,10/12/2020,NULL
251514,175619,1,9/1/2021,9618750,539794,421044,118750,9078956,N,NULL,9,10/12/2020,NULL
251515,175619,2,9/2/2021,9192443,539794,426307,113487,8652649,N,NULL,9,10/12/2020,NULL
251516,175619,3,9/3/2021,8760807,539794,431636,108158,8221013,N,NULL,9,10/12/2020,NULL
251517,175619,4,9/4/2021,8323776,539794,437031,102763,7783982,N,NULL,9,10/12/2020,NULL
251518,175619,5,9/5/2021,7881282,539794,442494,97300,7341488,N,NULL,9,10/12/2020,NULL
251519,175619,6,9/6/2021,7433257,539794,448025,91769,6893463,N,NULL,9,10/12/2020,NULL
251520,175619,7,9/7/2021,6979632,539794,453625,86168,6439838,N,NULL,9,10/12/2020,NULL
251521,175619,8,9/8/2021,6520336,539794,459296,80498,5980542,N,NULL,9,10/12/2020,NULL
251522,175619,9,9/9/2021,6055299,539794,465037,74757,5515505,N,NULL,9,10/12/2020,NULL
251523,175619,10,9/10/2021,5584449,539794,470850,68944,5044655,N,NULL,9,10/12/2020,NULL
251524,175619,11,9/11/2021,5107713,539794,476736,63058,4567919,N,NULL,9,10/12/2020,NULL
251525,175619,12,9/12/2021,4625018,539794,482695,57099,4085224,N,NULL,9,10/12/2020,NULL
251526,175619,13,9/1/2022,4136290,539794,488728,51065,3596496,N,NULL,9,10/12/2020,NULL
251527,175619,14,9/2/2022,3641453,539794,494837,44956,3101659,N,NULL,9,10/12/2020,NULL
251528,175619,15,9/3/2022,3140430,539794,501023,38771,2600636,N,NULL,9,10/12/2020,NULL
251529,175619,16,9/4/2022,2633144,539794,507286,32508,2093350,N,NULL,9,10/12/2020,NULL
251530,175619,17,9/5/2022,2119517,539794,513627,26167,1579723,N,NULL,9,10/12/2020,NULL
251531,175619,18,9/6/2022,1599470,539794,520047,19747,1059676,N,NULL,9,10/12/2020,NULL
251532,175619,19,9/7/2022,1072922,539794,526548,13246,533128,N,NULL,9,10/12/2020,NULL
251533,175619,20,9/8/2022,539792,539794,533128,6664,0,N,NULL,9,10/12/2020,NULL
251534,175620,1,9/1/2021,8235540,309965,208291,101673,7925575,N,NULL,9,10/12/2020,NULL
251535,175620,2,9/2/2021,8024645,309965,210895,99070,7714680,N,NULL,9,10/12/2020,NULL
251536,175620,3,9/3/2021,7811114,309965,213531,96433,7501149,N,NULL,9,10/12/2020,NULL
251537,175620,4,9/4/2021,7594914,309965,216200,93764,7284949,N,NULL,9,10/12/2020,NULL
251538,175620,5,9/5/2021,7376011,309965,218903,91062,7066046,N,NULL,9,10/12/2020,NULL
251539,175620,6,9/6/2021,7154372,309965,221639,88326,6844407,N,NULL,9,10/12/2020,NULL
251540,175620,7,9/7/2021,6929962,309965,224410,85555,6619997,N,NULL,9,10/12/2020,NULL
251541,175620,8,9/8/2021,6702747,309965,227215,82750,6392782,N,NULL,9,10/12/2020,NULL
251542,175620,9,9/9/2021,6472692,309965,230055,79910,6162727,N,NULL,9,10/12/2020,NULL
251543,175620,10,9/10/2021,6239761,309965,232931,77034,5929796,N,NULL,9,10/12/2020,NULL
251544,175620,11,9/11/2021,6003919,309965,235842,74122,5693954,N,NULL,9,10/12/2020,NULL
251545,175620,12,9/12/2021,5765129,309965,238790,71174,5455164,N,NULL,9,10/12/2020,NULL
251546,175620,13,9/1/2022,5523354,309965,241775,68190,5213389,N,NULL,9,10/12/2020,NULL
251547,175620,14,9/2/2022,5278557,309965,244797,65167,4968592,N,NULL,9,10/12/2020,NULL
251548,175620,15,9/3/2022,5030700,309965,247857,62107,4720735,N,NULL,9,10/12/2020,NULL
251549,175620,16,9/4/2022,4779745,309965,250955,59009,4469780,N,NULL,9,10/12/2020,NULL
251550,175620,17,9/5/2022,4525653,309965,254092,55872,4215688,N,NULL,9,10/12/2020,NULL
251551,175620,18,9/6/2022,4268384,309965,257269,52696,3958419,N,NULL,9,10/12/2020,NULL
251552,175620,19,9/7/2022,4007900,309965,260484,49480,3697935,N,NULL,9,10/12/2020,NULL
251553,175620,20,9/8/2022,3744160,309965,263740,46224,3434195,N,NULL,9,10/12/2020,NULL
251554,175620,21,9/9/2022,3477123,309965,267037,42927,3167158,N,NULL,9,10/12/2020,NULL
251555,175620,22,9/10/2022,3206748,309965,270375,39589,2896783,N,NULL,9,10/12/2020,NULL
251556,175620,23,9/11/2022,2932993,309965,273755,36210,2623028,N,NULL,9,10/12/2020,NULL
251557,175620,24,9/12/2022,2655816,309965,277177,32788,2345851,N,NULL,9,10/12/2020,NULL
251558,175620,25,9/1/2023,2375175,309965,280641,29323,2065210,N,NULL,9,10/12/2020,NULL
251559,175620,26,9/2/2023,2091026,309965,284149,25815,1781061,N,NULL,9,10/12/2020,NULL
251560,175620,27,9/3/2023,1803325,309965,287701,22263,1493360,N,NULL,9,10/12/2020,NULL
251561,175620,28,9/4/2023,1512027,309965,291298,18667,1202062,N,NULL,9,10/12/2020,NULL
251562,175620,29,9/5/2023,1217088,309965,294939,15026,907123,N,NULL,9,10/12/2020,NULL
251563,175620,30,9/6/2023,918462,309965,298626,11339,608497,N,NULL,9,10/12/2020,NULL
251564,175620,31,9/7/2023,616104,309965,302358,7606,306139,N,NULL,9,10/12/2020,NULL
251565,175620,32,9/8/2023,309966,309965,306139,3827,0,N,NULL,9,10/12/2020,NULL
251566,175621,1,9/1/2021,1518750,311343,292593,18750,1207407,N,NULL,9,10/12/2020,NULL
251567,175621,2,9/2/2021,1222499,311343,296251,15093,911156,N,NULL,9,10/12/2020,NULL
251568,175621,3,9/3/2021,922545,311343,299954,11389,611202,N,NULL,9,10/12/2020,NULL
251569,175621,4,9/4/2021,618842,311343,303703,7640,307499,N,NULL,9,10/12/2020,NULL
251570,175621,5,9/5/2021,311343,311343,307499,3844,0,N,NULL,9,10/12/2020,NULL
251571,175622,1,10/1/2021,2025000,348068,323068,25000,1676932,N,NULL,9,11/12/2020,NULL
251572,175622,2,10/2/2021,1697894,348068,327106,20962,1349826,N,NULL,9,11/12/2020,NULL
251573,175622,3,10/3/2021,1366699,348068,331195,16873,1018631,N,NULL,9,11/12/2020,NULL
251574,175622,4,10/4/2021,1031364,348068,335335,12733,683296,N,NULL,9,11/12/2020,NULL
251575,175622,5,10/5/2021,691838,348068,339526,8541,343770,N,NULL,9,11/12/2020,NULL
251576,175622,6,10/6/2021,348068,348068,343770,4297,0,N,NULL,9,11/12/2020,NULL
251577,175623,1,10/1/2021,3037500,396399,358899,37500,2641101,N,NULL,9,11/12/2020,NULL
251578,175623,2,10/2/2021,2674114,396399,363386,33014,2277715,N,NULL,9,11/12/2020,NULL
251579,175623,3,10/3/2021,2306186,396399,367928,28471,1909787,N,NULL,9,11/12/2020,NULL
251580,175623,4,10/4/2021,1933659,396399,372527,23872,1537260,N,NULL,9,11/12/2020,NULL
251581,175623,5,10/5/2021,1556475,396399,377184,19216,1160076,N,NULL,9,11/12/2020,NULL
251582,175623,6,10/6/2021,1174577,396399,381898,14501,778178,N,NULL,9,11/12/2020,NULL
251583,175623,7,10/7/2021,787905,396399,386672,9727,391506,N,NULL,9,11/12/2020,NULL
251584,175623,8,10/8/2021,396399,396399,391506,4894,0,N,NULL,9,11/12/2020,NULL
251585,175624,1,10/1/2021,69053177,1898076,1045567,852508,67155101,N,NULL,9,11/12/2020,NULL
251586,175624,2,10/2/2021,67994540,1898076,1058637,839439,66096464,N,NULL,9,11/12/2020,NULL
251587,175624,3,10/3/2021,66922670,1898076,1071870,826206,65024594,N,NULL,9,11/12/2020,NULL
251588,175624,4,10/4/2021,65837402,1898076,1085268,812807,63939326,N,NULL,9,11/12/2020,NULL
251589,175624,5,10/5/2021,64738568,1898076,1098834,799242,62840492,N,NULL,9,11/12/2020,NULL
251590,175624,6,10/6/2021,63625999,1898076,1112569,785506,61727923,N,NULL,9,11/12/2020,NULL
251591,175624,7,10/7/2021,62499522,1898076,1126477,771599,60601446,N,NULL,9,11/12/2020,NULL
251592,175624,8,10/8/2021,61358964,1898076,1140558,757518,59460888,N,NULL,9,11/12/2020,NULL
251593,175624,9,10/9/2021,60204149,1898076,1154815,743261,58306073,N,NULL,9,11/12/2020,NULL
251594,175624,10,10/10/2021,59034899,1898076,1169250,728826,57136823,N,NULL,9,11/12/2020,NULL
251595,175624,11,10/11/2021,57851034,1898076,1183865,714210,55952958,N,NULL,9,11/12/2020,NULL
251596,175624,12,10/12/2021,56652370,1898076,1198664,699412,54754294,N,NULL,9,11/12/2020,NULL
251597,175624,13,10/1/2022,55438723,1898076,1213647,684429,53540647,N,NULL,9,11/12/2020,NULL
251598,175624,14,10/2/2022,54209905,1898076,1228818,669258,52311829,N,NULL,9,11/12/2020,NULL
251599,175624,15,10/3/2022,52965727,1898076,1244178,653898,51067651,N,NULL,9,11/12/2020,NULL
251600,175624,16,10/4/2022,51705997,1898076,1259730,638346,49807921,N,NULL,9,11/12/2020,NULL
251601,175624,17,10/5/2022,50430520,1898076,1275477,622599,48532444,N,NULL,9,11/12/2020,NULL
251602,175624,18,10/6/2022,49139100,1898076,1291420,606656,47241024,N,NULL,9,11/12/2020,NULL
251603,175624,19,10/7/2022,47831537,1898076,1307563,590513,45933461,N,NULL,9,11/12/2020,NULL
251604,175624,20,10/8/2022,46507630,1898076,1323907,574168,44609554,N,NULL,9,11/12/2020,NULL
251605,175624,21,10/9/2022,45167174,1898076,1340456,557619,43269098,N,NULL,9,11/12/2020,NULL
251606,175624,22,10/10/2022,43809962,1898076,1357212,540864,41911886,N,NULL,9,11/12/2020,NULL
251607,175624,23,10/11/2022,42435785,1898076,1374177,523899,40537709,N,NULL,9,11/12/2020,NULL
251608,175624,24,10/12/2022,41044431,1898076,1391354,506721,39146355,N,NULL,9,11/12/2020,NULL
251609,175624,25,10/1/2023,39635685,1898076,1408746,489329,37737609,N,NULL,9,11/12/2020,NULL
251610,175624,26,10/2/2023,38209330,1898076,1426355,471720,36311254,N,NULL,9,11/12/2020,NULL
251611,175624,27,10/3/2023,36765145,1898076,1444185,453891,34867069,N,NULL,9,11/12/2020,NULL
251612,175624,28,10/4/2023,35302908,1898076,1462237,435838,33404832,N,NULL,9,11/12/2020,NULL
251613,175624,29,10/5/2023,33822393,1898076,1480515,417560,31924317,N,NULL,9,11/12/2020,NULL
251614,175624,30,10/6/2023,32323371,1898076,1499022,399054,30425295,N,NULL,9,11/12/2020,NULL
251615,175624,31,10/7/2023,30805612,1898076,1517759,380316,28907536,N,NULL,9,11/12/2020,NULL
251616,175624,32,10/8/2023,29268881,1898076,1536731,361344,27370805,N,NULL,9,11/12/2020,NULL
251617,175624,33,10/9/2023,27712940,1898076,1555941,342135,25814864,N,NULL,9,11/12/2020,NULL
251618,175624,34,10/10/2023,26137550,1898076,1575390,322686,24239474,N,NULL,9,11/12/2020,NULL
251619,175624,35,10/11/2023,24542468,1898076,1595082,302993,22644392,N,NULL,9,11/12/2020,NULL
251620,175624,36,10/12/2023,22927447,1898076,1615021,283055,21029371,N,NULL,9,11/12/2020,NULL
251621,175624,37,10/1/2024,21292239,1898076,1635208,262867,19394163,N,NULL,9,11/12/2020,NULL
251622,175624,38,10/2/2024,19636590,1898076,1655649,242427,17738514,N,NULL,9,11/12/2020,NULL
251623,175624,39,10/3/2024,17960246,1898076,1676344,221731,16062170,N,NULL,9,11/12/2020,NULL
251624,175624,40,10/4/2024,16262948,1898076,1697298,200777,14364872,N,NULL,9,11/12/2020,NULL
251625,175624,41,10/5/2024,14544433,1898076,1718515,179561,12646357,N,NULL,9,11/12/2020,NULL
251626,175624,42,10/6/2024,12804437,1898076,1739996,158079,10906361,N,NULL,9,11/12/2020,NULL
251627,175624,43,10/7/2024,11042691,1898076,1761746,136330,9144615,N,NULL,9,11/12/2020,NULL
251628,175624,44,10/8/2024,9258923,1898076,1783768,114308,7360847,N,NULL,9,11/12/2020,NULL
251629,175624,45,10/9/2024,7452858,1898076,1806065,92011,5554782,N,NULL,9,11/12/2020,NULL
251630,175624,46,10/10/2024,5624217,1898076,1828641,69435,3726141,N,NULL,9,11/12/2020,NULL
251631,175624,47,10/11/2024,3772718,1898076,1851499,46577,1874642,N,NULL,9,11/12/2020,NULL
251632,175624,48,10/12/2024,1898075,1898076,1874642,23433,0,N,NULL,9,11/12/2020,NULL
251633,175625,1,10/1/2021,53169411,1249281,592868,656412,51920130,N,NULL,9,11/12/2020,NULL
251634,175625,2,10/2/2021,52569132,1249281,600279,649002,51319851,N,NULL,9,11/12/2020,NULL
251635,175625,3,10/3/2021,51961350,1249281,607782,641498,50712069,N,NULL,9,11/12/2020,NULL
251636,175625,4,10/4/2021,51345970,1249281,615380,633901,50096689,N,NULL,9,11/12/2020,NULL
251637,175625,5,10/5/2021,50722898,1249281,623072,626209,49473617,N,NULL,9,11/12/2020,NULL
251638,175625,6,10/6/2021,50092038,1249281,630860,618420,48842757,N,NULL,9,11/12/2020,NULL
251639,175625,7,10/7/2021,49453292,1249281,638746,610534,48204011,N,NULL,9,11/12/2020,NULL
251640,175625,8,10/8/2021,48806562,1249281,646730,602550,47557281,N,NULL,9,11/12/2020,NULL
251641,175625,9,10/9/2021,48151747,1249281,654815,594466,46902466,N,NULL,9,11/12/2020,NULL
251642,175625,10,10/10/2021,47488747,1249281,663000,586281,46239466,N,NULL,9,11/12/2020,NULL
251643,175625,11,10/11/2021,46817460,1249281,671287,577993,45568179,N,NULL,9,11/12/2020,NULL
251644,175625,12,10/12/2021,46137782,1249281,679678,569602,44888501,N,NULL,9,11/12/2020,NULL
251645,175625,13,10/1/2022,45449608,1249281,688174,561106,44200327,N,NULL,9,11/12/2020,NULL
251646,175625,14,10/2/2022,44752832,1249281,696776,552504,43503551,N,NULL,9,11/12/2020,NULL
251647,175625,15,10/3/2022,44047346,1249281,705486,543794,42798065,N,NULL,9,11/12/2020,NULL
251648,175625,16,10/4/2022,43333041,1249281,714305,534976,42083760,N,NULL,9,11/12/2020,NULL
251649,175625,17,10/5/2022,42609807,1249281,723234,526047,41360526,N,NULL,9,11/12/2020,NULL
251650,175625,18,10/6/2022,41877533,1249281,732274,517007,40628252,N,NULL,9,11/12/2020,NULL
251651,175625,19,10/7/2022,41136106,1249281,741427,507853,39886825,N,NULL,9,11/12/2020,NULL
251652,175625,20,10/8/2022,40385411,1249281,750695,498585,39136130,N,NULL,9,11/12/2020,NULL
251653,175625,21,10/9/2022,39625332,1249281,760079,489202,38376051,N,NULL,9,11/12/2020,NULL
251654,175625,22,10/10/2022,38855752,1249281,769580,479701,37606471,N,NULL,9,11/12/2020,NULL
251655,175625,23,10/11/2022,38076552,1249281,779200,470081,36827271,N,NULL,9,11/12/2020,NULL
251656,175625,24,10/12/2022,37287612,1249281,788940,460341,36038331,N,NULL,9,11/12/2020,NULL
251657,175625,25,10/1/2023,36488811,1249281,798801,450479,35239530,N,NULL,9,11/12/2020,NULL
251658,175625,26,10/2/2023,35680025,1249281,808786,440494,34430744,N,NULL,9,11/12/2020,NULL
251659,175625,27,10/3/2023,34861129,1249281,818896,430384,33611848,N,NULL,9,11/12/2020,NULL
251660,175625,28,10/4/2023,34031997,1249281,829132,420148,32782716,N,NULL,9,11/12/2020,NULL
251661,175625,29,10/5/2023,33192500,1249281,839497,409784,31943219,N,NULL,9,11/12/2020,NULL
251662,175625,30,10/6/2023,32342510,1249281,849990,399290,31093229,N,NULL,9,11/12/2020,NULL
251663,175625,31,10/7/2023,31481895,1249281,860615,388665,30232614,N,NULL,9,11/12/2020,NULL
251664,175625,32,10/8/2023,30610522,1249281,871373,377908,29361241,N,NULL,9,11/12/2020,NULL
251665,175625,33,10/9/2023,29728257,1249281,882265,367015,28478976,N,NULL,9,11/12/2020,NULL
251666,175625,34,10/10/2023,28834964,1249281,893293,355987,27585683,N,NULL,9,11/12/2020,NULL
251667,175625,35,10/11/2023,27930504,1249281,904460,344821,26681223,N,NULL,9,11/12/2020,NULL
251668,175625,36,10/12/2023,27014739,1249281,915765,333515,25765458,N,NULL,9,11/12/2020,NULL
251669,175625,37,10/1/2024,26087527,1249281,927212,322068,24838246,N,NULL,9,11/12/2020,NULL
251670,175625,38,10/2/2024,25148724,1249281,938803,310478,23899443,N,NULL,9,11/12/2020,NULL
251671,175625,39,10/3/2024,24198186,1249281,950538,298743,22948905,N,NULL,9,11/12/2020,NULL
251672,175625,40,10/4/2024,23235767,1249281,962419,286861,21986486,N,NULL,9,11/12/2020,NULL
251673,175625,41,10/5/2024,22261317,1249281,974450,274831,21012036,N,NULL,9,11/12/2020,NULL
251674,175625,42,10/6/2024,21274687,1249281,986630,262650,20025406,N,NULL,9,11/12/2020,NULL
251675,175625,43,10/7/2024,20275724,1249281,998963,250318,19026443,N,NULL,9,11/12/2020,NULL
251676,175625,44,10/8/2024,19264274,1249281,1011450,237831,18014993,N,NULL,9,11/12/2020,NULL
251677,175625,45,10/9/2024,18240181,1249281,1024093,225187,16990900,N,NULL,9,11/12/2020,NULL
251678,175625,46,10/10/2024,17203287,1249281,1036894,212386,15954006,N,NULL,9,11/12/2020,NULL
251679,175625,47,10/11/2024,16153431,1249281,1049856,199425,14904150,N,NULL,9,11/12/2020,NULL
251680,175625,48,10/12/2024,15090452,1249281,1062979,186302,13841171,N,NULL,9,11/12/2020,NULL
251681,175625,49,10/1/2025,14014186,1249281,1076266,173015,12764905,N,NULL,9,11/12/2020,NULL
251682,175625,50,10/2/2025,12924467,1249281,1089719,159561,11675186,N,NULL,9,11/12/2020,NULL
251683,175625,51,10/3/2025,11821126,1249281,1103341,145940,10571845,N,NULL,9,11/12/2020,NULL
251684,175625,52,10/4/2025,10703993,1249281,1117133,132148,9454712,N,NULL,9,11/12/2020,NULL
251685,175625,53,10/5/2025,9572896,1249281,1131097,118184,8323615,N,NULL,9,11/12/2020,NULL
251686,175625,54,10/6/2025,8427661,1249281,1145235,104045,7178380,N,NULL,9,11/12/2020,NULL
251687,175625,55,10/7/2025,7268110,1249281,1159551,89730,6018829,N,NULL,9,11/12/2020,NULL
251688,175625,56,10/8/2025,6094065,1249281,1174045,75235,4844784,N,NULL,9,11/12/2020,NULL
251689,175625,57,10/9/2025,4905344,1249281,1188721,60560,3656063,N,NULL,9,11/12/2020,NULL
251690,175625,58,10/10/2025,3701764,1249281,1203580,45701,2452483,N,NULL,9,11/12/2020,NULL
251691,175625,59,10/11/2025,2483139,1249281,1218625,30656,1233858,N,NULL,9,11/12/2020,NULL
251692,175625,60,10/12/2025,1249282,1249281,1233858,15423,0,N,NULL,9,11/12/2020,NULL
251693,175626,1,10/1/2021,102517745,3232110,1966459,1265651,99285635,N,NULL,9,11/12/2020,NULL
251694,175626,2,10/2/2021,100526705,3232110,1991040,1241070,97294595,N,NULL,9,11/12/2020,NULL
251695,175626,3,10/3/2021,98510777,3232110,2015928,1216182,95278667,N,NULL,9,11/12/2020,NULL
251696,175626,4,10/4/2021,96469650,3232110,2041127,1190983,93237540,N,NULL,9,11/12/2020,NULL
251697,175626,5,10/5/2021,94403009,3232110,2066641,1165469,91170899,N,NULL,9,11/12/2020,NULL
251698,175626,6,10/6/2021,92310535,3232110,2092474,1139636,89078425,N,NULL,9,11/12/2020,NULL
251699,175626,7,10/7/2021,90191905,3232110,2118630,1113480,86959795,N,NULL,9,11/12/2020,NULL
251700,175626,8,10/8/2021,88046792,3232110,2145113,1086997,84814682,N,NULL,9,11/12/2020,NULL
251701,175626,9,10/9/2021,85874866,3232110,2171926,1060184,82642756,N,NULL,9,11/12/2020,NULL
251702,175626,10,10/10/2021,83675790,3232110,2199076,1033034,80443680,N,NULL,9,11/12/2020,NULL
251703,175626,11,10/11/2021,81449226,3232110,2226564,1005546,78217116,N,NULL,9,11/12/2020,NULL
251704,175626,12,10/12/2021,79194830,3232110,2254396,977714,75962720,N,NULL,9,11/12/2020,NULL
251705,175626,13,10/1/2022,76912254,3232110,2282576,949534,73680144,N,NULL,9,11/12/2020,NULL
251706,175626,14,10/2/2022,74601146,3232110,2311108,921002,71369036,N,NULL,9,11/12/2020,NULL
251707,175626,15,10/3/2022,72261149,3232110,2339997,892113,69029039,N,NULL,9,11/12/2020,NULL
251708,175626,16,10/4/2022,69891902,3232110,2369247,862863,66659792,N,NULL,9,11/12/2020,NULL
251709,175626,17,10/5/2022,67493039,3232110,2398863,833247,64260929,N,NULL,9,11/12/2020,NULL
251710,175626,18,10/6/2022,65064191,3232110,2428848,803262,61832081,N,NULL,9,11/12/2020,NULL
251711,175626,19,10/7/2022,62604982,3232110,2459209,772901,59372872,N,NULL,9,11/12/2020,NULL
251712,175626,20,10/8/2022,60115033,3232110,2489949,742161,56882923,N,NULL,9,11/12/2020,NULL
251713,175626,21,10/9/2022,57593960,3232110,2521073,711037,54361850,N,NULL,9,11/12/2020,NULL
251714,175626,22,10/10/2022,55041373,3232110,2552587,679523,51809263,N,NULL,9,11/12/2020,NULL
251715,175626,23,10/11/2022,52456879,3232110,2584494,647616,49224769,N,NULL,9,11/12/2020,NULL
251716,175626,24,10/12/2022,49840079,3232110,2616800,615310,46607969,N,NULL,9,11/12/2020,NULL
251717,175626,25,10/1/2023,47190569,3232110,2649510,582600,43958459,N,NULL,9,11/12/2020,NULL
251718,175626,26,10/2/2023,44507940,3232110,2682629,549481,41275830,N,NULL,9,11/12/2020,NULL
251719,175626,27,10/3/2023,41791778,3232110,2716162,515948,38559668,N,NULL,9,11/12/2020,NULL
251720,175626,28,10/4/2023,39041664,3232110,2750114,481996,35809554,N,NULL,9,11/12/2020,NULL
251721,175626,29,10/5/2023,36257173,3232110,2784491,447619,33025063,N,NULL,9,11/12/2020,NULL
251722,175626,30,10/6/2023,33437876,3232110,2819297,412813,30205766,N,NULL,9,11/12/2020,NULL
251723,175626,31,10/7/2023,30583338,3232110,2854538,377572,27351228,N,NULL,9,11/12/2020,NULL
251724,175626,32,10/8/2023,27693118,3232110,2890220,341890,24461008,N,NULL,9,11/12/2020,NULL
251725,175626,33,10/9/2023,24766771,3232110,2926347,305763,21534661,N,NULL,9,11/12/2020,NULL
251726,175626,34,10/10/2023,21803844,3232110,2962927,269183,18571734,N,NULL,9,11/12/2020,NULL
251727,175626,35,10/11/2023,18803881,3232110,2999963,232147,15571771,N,NULL,9,11/12/2020,NULL
251728,175626,36,10/12/2023,15766418,3232110,3037463,194647,12534308,N,NULL,9,11/12/2020,NULL
251729,175626,37,10/1/2024,12690987,3232110,3075431,156679,9458877,N,NULL,9,11/12/2020,NULL
251730,175626,38,10/2/2024,9577113,3232110,3113874,118236,6345003,N,NULL,9,11/12/2020,NULL
251731,175626,39,10/3/2024,6424316,3232110,3152797,79313,3192206,N,NULL,9,11/12/2020,NULL
251732,175626,40,10/4/2024,3232109,3232110,3192206,39903,0,N,NULL,9,11/12/2020,NULL
251733,175627,1,11/1/2021,83070557,1951845,926282,1025562,81118712,N,NULL,9,14/12/2020,NULL
251734,175627,2,11/2/2021,82132696,1951845,937861,1013984,80180851,N,NULL,9,14/12/2020,NULL
251735,175627,3,11/3/2021,81183112,1951845,949584,1002261,79231267,N,NULL,9,14/12/2020,NULL
251736,175627,4,11/4/2021,80221658,1951845,961454,990391,78269813,N,NULL,9,14/12/2020,NULL
251737,175627,5,11/5/2021,79248186,1951845,973472,978373,77296341,N,NULL,9,14/12/2020,NULL
251738,175627,6,11/6/2021,78262546,1951845,985640,966204,76310701,N,NULL,9,14/12/2020,NULL
251739,175627,7,11/7/2021,77264585,1951845,997961,953884,75312740,N,NULL,9,14/12/2020,NULL
251740,175627,8,11/8/2021,76254150,1951845,1010435,941409,74302305,N,NULL,9,14/12/2020,NULL
251741,175627,9,11/9/2021,75231084,1951845,1023066,928779,73279239,N,NULL,9,14/12/2020,NULL
251742,175627,10,11/10/2021,74195230,1951845,1035854,915990,72243385,N,NULL,9,14/12/2020,NULL
251743,175627,11,11/11/2021,73146428,1951845,1048802,903042,71194583,N,NULL,9,14/12/2020,NULL
251744,175627,12,11/12/2021,72084516,1951845,1061912,889932,70132671,N,NULL,9,14/12/2020,NULL
251745,175627,13,11/1/2022,71009330,1951845,1075186,876658,69057485,N,NULL,9,14/12/2020,NULL
251746,175627,14,11/2/2022,69920704,1951845,1088626,863219,67968859,N,NULL,9,14/12/2020,NULL
251747,175627,15,11/3/2022,68818470,1951845,1102234,849611,66866625,N,NULL,9,14/12/2020,NULL
251748,175627,16,11/4/2022,67702458,1951845,1116012,835833,65750613,N,NULL,9,14/12/2020,NULL
251749,175627,17,11/5/2022,66572496,1951845,1129962,821883,64620651,N,NULL,9,14/12/2020,NULL
251750,175627,18,11/6/2022,65428409,1951845,1144087,807758,63476564,N,NULL,9,14/12/2020,NULL
251751,175627,19,11/7/2022,64270021,1951845,1158388,793457,62318176,N,NULL,9,14/12/2020,NULL
251752,175627,20,11/8/2022,63097154,1951845,1172867,778977,61145309,N,NULL,9,14/12/2020,NULL
251753,175627,21,11/9/2022,61909626,1951845,1187528,764316,59957781,N,NULL,9,14/12/2020,NULL
251754,175627,22,11/10/2022,60707254,1951845,1202372,749472,58755409,N,NULL,9,14/12/2020,NULL
251755,175627,23,11/11/2022,59489852,1951845,1217402,734443,57538007,N,NULL,9,14/12/2020,NULL
251756,175627,24,11/12/2022,58257232,1951845,1232620,719225,56305387,N,NULL,9,14/12/2020,NULL
251757,175627,25,11/1/2023,57009205,1951845,1248027,703817,55057360,N,NULL,9,14/12/2020,NULL
251758,175627,26,11/2/2023,55745577,1951845,1263628,688217,53793732,N,NULL,9,14/12/2020,NULL
251759,175627,27,11/3/2023,54466154,1951845,1279423,672422,52514309,N,NULL,9,14/12/2020,NULL
251760,175627,28,11/4/2023,53170738,1951845,1295416,656429,51218893,N,NULL,9,14/12/2020,NULL
251761,175627,29,11/5/2023,51859129,1951845,1311609,640236,49907284,N,NULL,9,14/12/2020,NULL
251762,175627,30,11/6/2023,50531125,1951845,1328004,623841,48579280,N,NULL,9,14/12/2020,NULL
251763,175627,31,11/7/2023,49186521,1951845,1344604,607241,47234676,N,NULL,9,14/12/2020,NULL
251764,175627,32,11/8/2023,47825110,1951845,1361411,590433,45873265,N,NULL,9,14/12/2020,NULL
251765,175627,33,11/9/2023,46446681,1951845,1378429,573416,44494836,N,NULL,9,14/12/2020,NULL
251766,175627,34,11/10/2023,45051022,1951845,1395659,556185,43099177,N,NULL,9,14/12/2020,NULL
251767,175627,35,11/11/2023,43637917,1951845,1413105,538740,41686072,N,NULL,9,14/12/2020,NULL
251768,175627,36,11/12/2023,42207148,1951845,1430769,521076,40255303,N,NULL,9,14/12/2020,NULL
251769,175627,37,11/1/2024,40758495,1951845,1448653,503191,38806650,N,NULL,9,14/12/2020,NULL
251770,175627,38,11/2/2024,39291733,1951845,1466762,485083,37339888,N,NULL,9,14/12/2020,NULL
251771,175627,39,11/3/2024,37806637,1951845,1485096,466749,35854792,N,NULL,9,14/12/2020,NULL
251772,175627,40,11/4/2024,36302977,1951845,1503660,448185,34351132,N,NULL,9,14/12/2020,NULL
251773,175627,41,11/5/2024,34780521,1951845,1522456,429389,32828676,N,NULL,9,14/12/2020,NULL
251774,175627,42,11/6/2024,33239035,1951845,1541486,410358,31287190,N,NULL,9,14/12/2020,NULL
251775,175627,43,11/7/2024,31678280,1951845,1560755,391090,29726435,N,NULL,9,14/12/2020,NULL
251776,175627,44,11/8/2024,30098016,1951845,1580264,371580,28146171,N,NULL,9,14/12/2020,NULL
251777,175627,45,11/9/2024,28497998,1951845,1600018,351827,26546153,N,NULL,9,14/12/2020,NULL
251778,175627,46,11/10/2024,26877980,1951845,1620018,331827,24926135,N,NULL,9,14/12/2020,NULL
251779,175627,47,11/11/2024,25237712,1951845,1640268,311577,23285867,N,NULL,9,14/12/2020,NULL
251780,175627,48,11/12/2024,23576941,1951845,1660771,291073,21625096,N,NULL,9,14/12/2020,NULL
251781,175627,49,11/1/2025,21895410,1951845,1681531,270314,19943565,N,NULL,9,14/12/2020,NULL
251782,175627,50,11/2/2025,20192860,1951845,1702550,249295,18241015,N,NULL,9,14/12/2020,NULL
251783,175627,51,11/3/2025,18469028,1951845,1723832,228013,16517183,N,NULL,9,14/12/2020,NULL
251784,175627,52,11/4/2025,16723648,1951845,1745380,206465,14771803,N,NULL,9,14/12/2020,NULL
251785,175627,53,11/5/2025,14956451,1951845,1767197,184648,13004606,N,NULL,9,14/12/2020,NULL
251786,175627,54,11/6/2025,13167164,1951845,1789287,162558,11215319,N,NULL,9,14/12/2020,NULL
251787,175627,55,11/7/2025,11355511,1951845,1811653,140191,9403666,N,NULL,9,14/12/2020,NULL
251788,175627,56,11/8/2025,9521212,1951845,1834299,117546,7569367,N,NULL,9,14/12/2020,NULL
251789,175627,57,11/9/2025,7663984,1951845,1857228,94617,5712139,N,NULL,9,14/12/2020,NULL
251790,175627,58,11/10/2025,5783541,1951845,1880443,71402,3831696,N,NULL,9,14/12/2020,NULL
251791,175627,59,11/11/2025,3879593,1951845,1903948,47896,1927748,N,NULL,9,14/12/2020,NULL
251792,175627,60,11/12/2025,1951845,1951845,1927748,24097,0,N,NULL,9,14/12/2020,NULL
251793,175628,1,11/1/2021,10120878,902216,777267,124949,9218662,N,NULL,9,14/12/2020,NULL
251794,175628,2,11/2/2021,9333896,902216,786982,115233,8431680,N,NULL,9,14/12/2020,NULL
251795,175628,3,11/3/2021,8537076,902216,796820,105396,7634860,N,NULL,9,14/12/2020,NULL
251796,175628,4,11/4/2021,7730296,902216,806780,95436,6828080,N,NULL,9,14/12/2020,NULL
251797,175628,5,11/5/2021,6913431,902216,816865,85351,6011215,N,NULL,9,14/12/2020,NULL
251798,175628,6,11/6/2021,6086356,902216,827075,75140,5184140,N,NULL,9,14/12/2020,NULL
251799,175628,7,11/7/2021,5248942,902216,837414,64802,4346726,N,NULL,9,14/12/2020,NULL
251800,175628,8,11/8/2021,4401060,902216,847882,54334,3498844,N,NULL,9,14/12/2020,NULL
251801,175628,9,11/9/2021,3542580,902216,858480,43736,2640364,N,NULL,9,14/12/2020,NULL
251802,175628,10,11/10/2021,2673369,902216,869211,33005,1771153,N,NULL,9,14/12/2020,NULL
251803,175628,11,11/11/2021,1793293,902216,880076,22139,891077,N,NULL,9,14/12/2020,NULL
251804,175628,12,11/12/2021,902216,902216,891077,11138,0,N,NULL,9,14/12/2020,NULL
251805,175629,1,11/1/2021,2936250,747797,711547,36250,2188453,N,NULL,9,14/12/2020,NULL
251806,175629,2,11/2/2021,2215809,747797,720441,27356,1468012,N,NULL,9,14/12/2020,NULL
251807,175629,3,11/3/2021,1486362,747797,729447,18350,738565,N,NULL,9,14/12/2020,NULL
251808,175629,4,11/4/2021,747797,747797,738565,9232,0,N,NULL,9,14/12/2020,NULL
251809,175630,1,11/1/2021,91125000,2767415,1642415,1125000,88357585,N,NULL,9,14/12/2020,NULL
251810,175630,2,11/2/2021,89462054,2767415,1662946,1104470,86694639,N,NULL,9,14/12/2020,NULL
251811,175630,3,11/3/2021,87778322,2767415,1683732,1083683,85010907,N,NULL,9,14/12/2020,NULL
251812,175630,4,11/4/2021,86073543,2767415,1704779,1062636,83306128,N,NULL,9,14/12/2020,NULL
251813,175630,5,11/5/2021,84347454,2767415,1726089,1041327,81580039,N,NULL,9,14/12/2020,NULL
251814,175630,6,11/6/2021,82599789,2767415,1747665,1019750,79832374,N,NULL,9,14/12/2020,NULL
251815,175630,7,11/7/2021,80830278,2767415,1769511,997905,78062863,N,NULL,9,14/12/2020,NULL
251816,175630,8,11/8/2021,79038648,2767415,1791630,975786,76271233,N,NULL,9,14/12/2020,NULL
251817,175630,9,11/9/2021,77224623,2767415,1814025,953390,74457208,N,NULL,9,14/12/2020,NULL
251818,175630,10,11/10/2021,75387923,2767415,1836700,930715,72620508,N,NULL,9,14/12/2020,NULL
251819,175630,11,11/11/2021,73528264,2767415,1859659,907756,70760849,N,NULL,9,14/12/2020,NULL
251820,175630,12,11/12/2021,71645359,2767415,1882905,884511,68877944,N,NULL,9,14/12/2020,NULL
251821,175630,13,11/1/2022,69738918,2767415,1906441,860974,66971503,N,NULL,9,14/12/2020,NULL
251822,175630,14,11/2/2022,67808646,2767415,1930272,837144,65041231,N,NULL,9,14/12/2020,NULL
251823,175630,15,11/3/2022,65854246,2767415,1954400,813015,63086831,N,NULL,9,14/12/2020,NULL
251824,175630,16,11/4/2022,63875416,2767415,1978830,788585,61108001,N,NULL,9,14/12/2020,NULL
251825,175630,17,11/5/2022,61871851,2767415,2003565,763850,59104436,N,NULL,9,14/12/2020,NULL
251826,175630,18,11/6/2022,59843241,2767415,2028610,738805,57075826,N,NULL,9,14/12/2020,NULL
251827,175630,19,11/7/2022,57789273,2767415,2053968,713448,55021858,N,NULL,9,14/12/2020,NULL
251828,175630,20,11/8/2022,55709631,2767415,2079642,687773,52942216,N,NULL,9,14/12/2020,NULL
251829,175630,21,11/9/2022,53603993,2767415,2105638,661778,50836578,N,NULL,9,14/12/2020,NULL
251830,175630,22,11/10/2022,51472035,2767415,2131958,635457,48704620,N,NULL,9,14/12/2020,NULL
251831,175630,23,11/11/2022,49313427,2767415,2158608,608808,46546012,N,NULL,9,14/12/2020,NULL
251832,175630,24,11/12/2022,47127837,2767415,2185590,581825,44360422,N,NULL,9,14/12/2020,NULL
251833,175630,25,11/1/2023,44914927,2767415,2212910,554505,42147512,N,NULL,9,14/12/2020,NULL
251834,175630,26,11/2/2023,42674355,2767415,2240572,526844,39906940,N,NULL,9,14/12/2020,NULL
251835,175630,27,11/3/2023,40405776,2767415,2268579,498837,37638361,N,NULL,9,14/12/2020,NULL
251836,175630,28,11/4/2023,38108840,2767415,2296936,470480,35341425,N,NULL,9,14/12/2020,NULL
251837,175630,29,11/5/2023,35783192,2767415,2325648,441768,33015777,N,NULL,9,14/12/2020,NULL
251838,175630,30,11/6/2023,33428474,2767415,2354718,412697,30661059,N,NULL,9,14/12/2020,NULL
251839,175630,31,11/7/2023,31044322,2767415,2384152,383263,28276907,N,NULL,9,14/12/2020,NULL
251840,175630,32,11/8/2023,28630368,2767415,2413954,353461,25862953,N,NULL,9,14/12/2020,NULL
251841,175630,33,11/9/2023,26186239,2767415,2444129,323287,23418824,N,NULL,9,14/12/2020,NULL
251842,175630,34,11/10/2023,23711559,2767415,2474680,292735,20944144,N,NULL,9,14/12/2020,NULL
251843,175630,35,11/11/2023,21205945,2767415,2505614,261802,18438530,N,NULL,9,14/12/2020,NULL
251844,175630,36,11/12/2023,18669011,2767415,2536934,230482,15901596,N,NULL,9,14/12/2020,NULL
251845,175630,37,11/1/2024,16100366,2767415,2568645,198770,13332951,N,NULL,9,14/12/2020,NULL
251846,175630,38,11/2/2024,13499612,2767415,2600754,166662,10732197,N,NULL,9,14/12/2020,NULL
251847,175630,39,11/3/2024,10866349,2767415,2633263,134152,8098934,N,NULL,9,14/12/2020,NULL
251848,175630,40,11/4/2024,8200170,2767415,2666179,101237,5432755,N,NULL,9,14/12/2020,NULL
251849,175630,41,11/5/2024,5500664,2767415,2699506,67909,2733249,N,NULL,9,14/12/2020,NULL
251850,175630,42,11/6/2024,2767414,2767415,2733249,34166,0,N,NULL,9,14/12/2020,NULL
251851,175631,1,14/01/2021,3035720,773130,735652,37478,2262590,N,NULL,9,14/12/2020,NULL
251852,175631,2,14/02/2021,2290873,773130,744847,28282,1517743,N,NULL,9,14/12/2020,NULL
251853,175631,3,14/03/2021,1536715,773130,754158,18972,763585,N,NULL,9,14/12/2020,NULL
251854,175631,4,14/04/2021,773130,773130,763585,9545,0,N,NULL,9,14/12/2020,NULL
251855,175535,1,13/02/2021,600603,202693,195279,7415,397910,R,NULL,10,15/12/2020,NULL
251856,175535,2,13/03/2021,402884,202693,197719,4974,200191,R,NULL,10,15/12/2020,NULL
251857,175535,3,13/04/2021,202693,202693,200191,2502,0,R,NULL,10,15/12/2020,NULL
251858,175535,1,13/01/2021,600603,202693,195279,7415,397910,R,NULL,10,15/12/2020,NULL
251859,175535,2,13/02/2021,402884,202693,197719,4974,200191,R,NULL,10,15/12/2020,NULL
251860,175535,3,13/03/2021,202693,202693,200191,2502,0,R,NULL,10,15/12/2020,NULL
251861,175535,1,13/01/2021,600603,202693,195279,7415,397910,N,NULL,10,15/12/2020,NULL
251862,175535,2,13/02/2021,402884,202693,197719,4974,200191,N,NULL,10,15/12/2020,NULL
251863,175535,3,13/03/2021,202693,202693,200191,2502,0,N,NULL,10,15/12/2020,NULL
251864,175632,1,27/12/2020,7087500,166530,79030,87500,6920970,N,NULL,9,15/12/2020,NULL
251865,175632,2,27/01/2021,7007483,166530,80017,86512,6840953,N,NULL,9,15/12/2020,NULL
251866,175632,3,27/02/2021,6926465,166530,81018,85512,6759935,N,NULL,9,15/12/2020,NULL
251867,175632,4,27/03/2021,6844435,166530,82030,84499,6677905,N,NULL,9,15/12/2020,NULL
251868,175632,5,27/04/2021,6761379,166530,83056,83474,6594849,N,NULL,9,15/12/2020,NULL
251869,175632,6,27/05/2021,6677285,166530,84094,82436,6510755,N,NULL,9,15/12/2020,NULL
251870,175632,7,27/06/2021,6592140,166530,85145,81384,6425610,N,NULL,9,15/12/2020,NULL
251871,175632,8,27/07/2021,6505931,166530,86209,80320,6339401,N,NULL,9,15/12/2020,NULL
251872,175632,9,27/08/2021,6418644,166530,87287,79243,6252114,N,NULL,9,15/12/2020,NULL
251873,175632,10,27/09/2021,6330266,166530,88378,78151,6163736,N,NULL,9,15/12/2020,NULL
251874,175632,11,27/10/2021,6240783,166530,89483,77047,6074253,N,NULL,9,15/12/2020,NULL
251875,175632,12,27/11/2021,6150182,166530,90601,75928,5983652,N,NULL,9,15/12/2020,NULL
251876,175632,13,27/12/2021,6058448,166530,91734,74796,5891918,N,NULL,9,15/12/2020,NULL
251877,175632,14,27/01/2022,5965567,166530,92881,73649,5799037,N,NULL,9,15/12/2020,NULL
251878,175632,15,27/02/2022,5871525,166530,94042,72488,5704995,N,NULL,9,15/12/2020,NULL
251879,175632,16,27/03/2022,5776308,166530,95217,71312,5609778,N,NULL,9,15/12/2020,NULL
251880,175632,17,27/04/2022,5679901,166530,96407,70122,5513371,N,NULL,9,15/12/2020,NULL
251881,175632,18,27/05/2022,5582289,166530,97612,68917,5415759,N,NULL,9,15/12/2020,NULL
251882,175632,19,27/06/2022,5483456,166530,98833,67697,5316926,N,NULL,9,15/12/2020,NULL
251883,175632,20,27/07/2022,5383388,166530,100068,66462,5216858,N,NULL,9,15/12/2020,NULL
251884,175632,21,27/08/2022,5282069,166530,101319,65211,5115539,N,NULL,9,15/12/2020,NULL
251885,175632,22,27/09/2022,5179484,166530,102585,63944,5012954,N,NULL,9,15/12/2020,NULL
251886,175632,23,27/10/2022,5075616,166530,103868,62662,4909086,N,NULL,9,15/12/2020,NULL
251887,175632,24,27/11/2022,4970450,166530,105166,61364,4803920,N,NULL,9,15/12/2020,NULL
251888,175632,25,27/12/2022,4863970,166530,106480,60049,4697440,N,NULL,9,15/12/2020,NULL
251889,175632,26,27/01/2023,4756158,166530,107812,58718,4589628,N,NULL,9,15/12/2020,NULL
251890,175632,27,27/02/2023,4646999,166530,109159,57370,4480469,N,NULL,9,15/12/2020,NULL
251891,175632,28,27/03/2023,4536475,166530,110524,56006,4369945,N,NULL,9,15/12/2020,NULL
251892,175632,29,27/04/2023,4424570,166530,111905,54624,4258040,N,NULL,9,15/12/2020,NULL
251893,175632,30,27/05/2023,4311266,166530,113304,53226,4144736,N,NULL,9,15/12/2020,NULL
251894,175632,31,27/06/2023,4196546,166530,114720,51809,4030016,N,NULL,9,15/12/2020,NULL
251895,175632,32,27/07/2023,4080392,166530,116154,50375,3913862,N,NULL,9,15/12/2020,NULL
251896,175632,33,27/08/2023,3962786,166530,117606,48923,3796256,N,NULL,9,15/12/2020,NULL
251897,175632,34,27/09/2023,3843710,166530,119076,47453,3677180,N,NULL,9,15/12/2020,NULL
251898,175632,35,27/10/2023,3723145,166530,120565,45965,3556615,N,NULL,9,15/12/2020,NULL
251899,175632,36,27/11/2023,3601073,166530,122072,44458,3434543,N,NULL,9,15/12/2020,NULL
251900,175632,37,27/12/2023,3477475,166530,123598,42932,3310945,N,NULL,9,15/12/2020,NULL
251901,175632,38,27/01/2024,3352332,166530,125143,41387,3185802,N,NULL,9,15/12/2020,NULL
251902,175632,39,27/02/2024,3225625,166530,126707,39823,3059095,N,NULL,9,15/12/2020,NULL
251903,175632,40,27/03/2024,3097334,166530,128291,38239,2930804,N,NULL,9,15/12/2020,NULL
251904,175632,41,27/04/2024,2967440,166530,129894,36635,2800910,N,NULL,9,15/12/2020,NULL
251905,175632,42,27/05/2024,2835922,166530,131518,35011,2669392,N,NULL,9,15/12/2020,NULL
251906,175632,43,27/06/2024,2702760,166530,133162,33367,2536230,N,NULL,9,15/12/2020,NULL
251907,175632,44,27/07/2024,2567933,166530,134827,31703,2401403,N,NULL,9,15/12/2020,NULL
251908,175632,45,27/08/2024,2431421,166530,136512,30018,2264891,N,NULL,9,15/12/2020,NULL
251909,175632,46,27/09/2024,2293203,166530,138218,28311,2126673,N,NULL,9,15/12/2020,NULL
251910,175632,47,27/10/2024,2153257,166530,139946,26583,1986727,N,NULL,9,15/12/2020,NULL
251911,175632,48,27/11/2024,2011562,166530,141695,24834,1845032,N,NULL,9,15/12/2020,NULL
251912,175632,49,27/12/2024,1868095,166530,143467,23063,1701565,N,NULL,9,15/12/2020,NULL
251913,175632,50,27/01/2025,1722835,166530,145260,21270,1556305,N,NULL,9,15/12/2020,NULL
251914,175632,51,27/02/2025,1575759,166530,147076,19454,1409229,N,NULL,9,15/12/2020,NULL
251915,175632,52,27/03/2025,1426845,166530,148914,17615,1260315,N,NULL,9,15/12/2020,NULL
251916,175632,53,27/04/2025,1276069,166530,150776,15754,1109539,N,NULL,9,15/12/2020,NULL
251917,175632,54,27/05/2025,1123409,166530,152660,13869,956879,N,NULL,9,15/12/2020,NULL
251918,175632,55,27/06/2025,968840,166530,154569,11961,802310,N,NULL,9,15/12/2020,NULL
251919,175632,56,27/07/2025,812339,166530,156501,10029,645809,N,NULL,9,15/12/2020,NULL
251920,175632,57,27/08/2025,653882,166530,158457,8073,487352,N,NULL,9,15/12/2020,NULL
251921,175632,58,27/09/2025,493444,166530,160438,6092,326914,N,NULL,9,15/12/2020,NULL
251922,175632,59,27/10/2025,331001,166530,162443,4086,164471,N,NULL,9,15/12/2020,NULL
251923,175632,60,27/11/2025,166527,166530,164471,2056,0,N,NULL,9,15/12/2020,NULL
251924,175633,1,27/12/2020,7087500,631808,544308,87500,6455692,N,NULL,9,15/12/2020,NULL
251925,175633,2,27/01/2021,6536388,631808,551112,80696,5904580,N,NULL,9,15/12/2020,NULL
251926,175633,3,27/02/2021,5978387,631808,558001,73807,5346579,N,NULL,9,15/12/2020,NULL
251927,175633,4,27/03/2021,5413411,631808,564976,66832,4781603,N,NULL,9,15/12/2020,NULL
251928,175633,5,27/04/2021,4841373,631808,572038,59770,4209565,N,NULL,9,15/12/2020,NULL
251929,175633,6,27/05/2021,4262184,631808,579189,52620,3630376,N,NULL,9,15/12/2020,NULL
251930,175633,7,27/06/2021,3675756,631808,586428,45380,3043948,N,NULL,9,15/12/2020,NULL
251931,175633,8,27/07/2021,3081997,631808,593759,38049,2450189,N,NULL,9,15/12/2020,NULL
251932,175633,9,27/08/2021,2480816,631808,601181,30627,1849008,N,NULL,9,15/12/2020,NULL
251933,175633,10,27/09/2021,1872120,631808,608696,23113,1240312,N,NULL,9,15/12/2020,NULL
251934,175633,11,27/10/2021,1255816,631808,616304,15504,624008,N,NULL,9,15/12/2020,NULL
251935,175633,12,27/11/2021,631808,631808,624008,7800,0,N,NULL,9,15/12/2020,NULL
251936,175634,1,27/12/2020,14175000,678813,503813,175000,13496187,N,NULL,9,15/12/2020,NULL
251937,175634,2,27/01/2021,13664889,678813,510111,168702,12986076,N,NULL,9,15/12/2020,NULL
251938,175634,3,27/02/2021,13148402,678813,516487,162326,12469589,N,NULL,9,15/12/2020,NULL
251939,175634,4,27/03/2021,12625459,678813,522943,155870,11946646,N,NULL,9,15/12/2020,NULL
251940,175634,5,27/04/2021,12095979,678813,529480,149333,11417166,N,NULL,9,15/12/2020,NULL
251941,175634,6,27/05/2021,11559881,678813,536098,142715,10881068,N,NULL,9,15/12/2020,NULL
251942,175634,7,27/06/2021,11017081,678813,542800,136013,10338268,N,NULL,9,15/12/2020,NULL
251943,175634,8,27/07/2021,10467496,678813,549585,129228,9788683,N,NULL,9,15/12/2020,NULL
251944,175634,9,27/08/2021,9911041,678813,556455,122359,9232228,N,NULL,9,15/12/2020,NULL
251945,175634,10,27/09/2021,9347631,678813,563410,115403,8668818,N,NULL,9,15/12/2020,NULL
251946,175634,11,27/10/2021,8777178,678813,570453,108360,8098365,N,NULL,9,15/12/2020,NULL
251947,175634,12,27/11/2021,8199594,678813,577584,101230,7520781,N,NULL,9,15/12/2020,NULL
251948,175634,13,27/12/2021,7614791,678813,584803,94010,6935978,N,NULL,9,15/12/2020,NULL
251949,175634,14,27/01/2022,7022678,678813,592113,86700,6343865,N,NULL,9,15/12/2020,NULL
251950,175634,15,27/02/2022,6423163,678813,599515,79298,5744350,N,NULL,9,15/12/2020,NULL
251951,175634,16,27/03/2022,5816154,678813,607009,71804,5137341,N,NULL,9,15/12/2020,NULL
251952,175634,17,27/04/2022,5201558,678813,614596,64217,4522745,N,NULL,9,15/12/2020,NULL
251953,175634,18,27/05/2022,4579279,678813,622279,56534,3900466,N,NULL,9,15/12/2020,NULL
251954,175634,19,27/06/2022,3949222,678813,630057,48756,3270409,N,NULL,9,15/12/2020,NULL
251955,175634,20,27/07/2022,3311289,678813,637933,40880,2632476,N,NULL,9,15/12/2020,NULL
251956,175634,21,27/08/2022,2665382,678813,645907,32906,1986569,N,NULL,9,15/12/2020,NULL
251957,175634,22,27/09/2022,2011401,678813,653981,24832,1332588,N,NULL,9,15/12/2020,NULL
251958,175634,23,27/10/2022,1349245,678813,662156,16657,670432,N,NULL,9,15/12/2020,NULL
251959,175634,24,27/11/2022,678812,678813,670432,8380,0,N,NULL,9,15/12/2020,NULL
251960,175635,1,27/12/2020,7087500,166530,79030,87500,6920970,N,NULL,9,15/12/2020,NULL
251961,175635,2,27/01/2021,7007483,166530,80017,86512,6840953,N,NULL,9,15/12/2020,NULL
251962,175635,3,27/02/2021,6926465,166530,81018,85512,6759935,N,NULL,9,15/12/2020,NULL
251963,175635,4,27/03/2021,6844435,166530,82030,84499,6677905,N,NULL,9,15/12/2020,NULL
251964,175635,5,27/04/2021,6761379,166530,83056,83474,6594849,N,NULL,9,15/12/2020,NULL
251965,175635,6,27/05/2021,6677285,166530,84094,82436,6510755,N,NULL,9,15/12/2020,NULL
251966,175635,7,27/06/2021,6592140,166530,85145,81384,6425610,N,NULL,9,15/12/2020,NULL
251967,175635,8,27/07/2021,6505931,166530,86209,80320,6339401,N,NULL,9,15/12/2020,NULL
251968,175635,9,27/08/2021,6418644,166530,87287,79243,6252114,N,NULL,9,15/12/2020,NULL
251969,175635,10,27/09/2021,6330266,166530,88378,78151,6163736,N,NULL,9,15/12/2020,NULL
251970,175635,11,27/10/2021,6240783,166530,89483,77047,6074253,N,NULL,9,15/12/2020,NULL
251971,175635,12,27/11/2021,6150182,166530,90601,75928,5983652,N,NULL,9,15/12/2020,NULL
251972,175635,13,27/12/2021,6058448,166530,91734,74796,5891918,N,NULL,9,15/12/2020,NULL
251973,175635,14,27/01/2022,5965567,166530,92881,73649,5799037,N,NULL,9,15/12/2020,NULL
251974,175635,15,27/02/2022,5871525,166530,94042,72488,5704995,N,NULL,9,15/12/2020,NULL
251975,175635,16,27/03/2022,5776308,166530,95217,71312,5609778,N,NULL,9,15/12/2020,NULL
251976,175635,17,27/04/2022,5679901,166530,96407,70122,5513371,N,NULL,9,15/12/2020,NULL
251977,175635,18,27/05/2022,5582289,166530,97612,68917,5415759,N,NULL,9,15/12/2020,NULL
251978,175635,19,27/06/2022,5483456,166530,98833,67697,5316926,N,NULL,9,15/12/2020,NULL
251979,175635,20,27/07/2022,5383388,166530,100068,66462,5216858,N,NULL,9,15/12/2020,NULL
251980,175635,21,27/08/2022,5282069,166530,101319,65211,5115539,N,NULL,9,15/12/2020,NULL
251981,175635,22,27/09/2022,5179484,166530,102585,63944,5012954,N,NULL,9,15/12/2020,NULL
251982,175635,23,27/10/2022,5075616,166530,103868,62662,4909086,N,NULL,9,15/12/2020,NULL
251983,175635,24,27/11/2022,4970450,166530,105166,61364,4803920,N,NULL,9,15/12/2020,NULL
251984,175635,25,27/12/2022,4863970,166530,106480,60049,4697440,N,NULL,9,15/12/2020,NULL
251985,175635,26,27/01/2023,4756158,166530,107812,58718,4589628,N,NULL,9,15/12/2020,NULL
251986,175635,27,27/02/2023,4646999,166530,109159,57370,4480469,N,NULL,9,15/12/2020,NULL
251987,175635,28,27/03/2023,4536475,166530,110524,56006,4369945,N,NULL,9,15/12/2020,NULL
251988,175635,29,27/04/2023,4424570,166530,111905,54624,4258040,N,NULL,9,15/12/2020,NULL
251989,175635,30,27/05/2023,4311266,166530,113304,53226,4144736,N,NULL,9,15/12/2020,NULL
251990,175635,31,27/06/2023,4196546,166530,114720,51809,4030016,N,NULL,9,15/12/2020,NULL
251991,175635,32,27/07/2023,4080392,166530,116154,50375,3913862,N,NULL,9,15/12/2020,NULL
251992,175635,33,27/08/2023,3962786,166530,117606,48923,3796256,N,NULL,9,15/12/2020,NULL
251993,175635,34,27/09/2023,3843710,166530,119076,47453,3677180,N,NULL,9,15/12/2020,NULL
251994,175635,35,27/10/2023,3723145,166530,120565,45965,3556615,N,NULL,9,15/12/2020,NULL
251995,175635,36,27/11/2023,3601073,166530,122072,44458,3434543,N,NULL,9,15/12/2020,NULL
251996,175635,37,27/12/2023,3477475,166530,123598,42932,3310945,N,NULL,9,15/12/2020,NULL
251997,175635,38,27/01/2024,3352332,166530,125143,41387,3185802,N,NULL,9,15/12/2020,NULL
251998,175635,39,27/02/2024,3225625,166530,126707,39823,3059095,N,NULL,9,15/12/2020,NULL
251999,175635,40,27/03/2024,3097334,166530,128291,38239,2930804,N,NULL,9,15/12/2020,NULL
252000,175635,41,27/04/2024,2967440,166530,129894,36635,2800910,N,NULL,9,15/12/2020,NULL
252001,175635,42,27/05/2024,2835922,166530,131518,35011,2669392,N,NULL,9,15/12/2020,NULL
252002,175635,43,27/06/2024,2702760,166530,133162,33367,2536230,N,NULL,9,15/12/2020,NULL
252003,175635,44,27/07/2024,2567933,166530,134827,31703,2401403,N,NULL,9,15/12/2020,NULL
252004,175635,45,27/08/2024,2431421,166530,136512,30018,2264891,N,NULL,9,15/12/2020,NULL
252005,175635,46,27/09/2024,2293203,166530,138218,28311,2126673,N,NULL,9,15/12/2020,NULL
252006,175635,47,27/10/2024,2153257,166530,139946,26583,1986727,N,NULL,9,15/12/2020,NULL
252007,175635,48,27/11/2024,2011562,166530,141695,24834,1845032,N,NULL,9,15/12/2020,NULL
252008,175635,49,27/12/2024,1868095,166530,143467,23063,1701565,N,NULL,9,15/12/2020,NULL
252009,175635,50,27/01/2025,1722835,166530,145260,21270,1556305,N,NULL,9,15/12/2020,NULL
252010,175635,51,27/02/2025,1575759,166530,147076,19454,1409229,N,NULL,9,15/12/2020,NULL
252011,175635,52,27/03/2025,1426845,166530,148914,17615,1260315,N,NULL,9,15/12/2020,NULL
252012,175635,53,27/04/2025,1276069,166530,150776,15754,1109539,N,NULL,9,15/12/2020,NULL
252013,175635,54,27/05/2025,1123409,166530,152660,13869,956879,N,NULL,9,15/12/2020,NULL
252014,175635,55,27/06/2025,968840,166530,154569,11961,802310,N,NULL,9,15/12/2020,NULL
252015,175635,56,27/07/2025,812339,166530,156501,10029,645809,N,NULL,9,15/12/2020,NULL
252016,175635,57,27/08/2025,653882,166530,158457,8073,487352,N,NULL,9,15/12/2020,NULL
252017,175635,58,27/09/2025,493444,166530,160438,6092,326914,N,NULL,9,15/12/2020,NULL
252018,175635,59,27/10/2025,331001,166530,162443,4086,164471,N,NULL,9,15/12/2020,NULL
252019,175635,60,27/11/2025,166527,166530,164471,2056,0,N,NULL,9,15/12/2020,NULL
252020,175636,1,27/12/2020,3037500,522101,484601,37500,2515399,N,NULL,9,15/12/2020,NULL
252021,175636,2,27/01/2021,2546841,522101,490659,31442,2024740,N,NULL,9,15/12/2020,NULL
252022,175636,3,27/02/2021,2050049,522101,496792,25309,1527948,N,NULL,9,15/12/2020,NULL
252023,175636,4,27/03/2021,1547047,522101,503002,19099,1024946,N,NULL,9,15/12/2020,NULL
252024,175636,5,27/04/2021,1037757,522101,509290,12812,515656,N,NULL,9,15/12/2020,NULL
252025,175636,6,27/05/2021,522101,522101,515656,6446,0,N,NULL,9,15/12/2020,NULL
252026,175637,1,27/12/2020,10357875,923343,795468,127875,9434532,N,NULL,9,15/12/2020,NULL
252027,175637,2,27/01/2021,9552464,923343,805411,117932,8629121,N,NULL,9,15/12/2020,NULL
252028,175637,3,27/02/2021,8736985,923343,815479,107864,7813642,N,NULL,9,15/12/2020,NULL
252029,175637,4,27/03/2021,7911313,923343,825672,97671,6987970,N,NULL,9,15/12/2020,NULL
252030,175637,5,27/04/2021,7075320,923343,835993,87350,6151977,N,NULL,9,15/12/2020,NULL
252031,175637,6,27/05/2021,6228877,923343,846443,76900,5305534,N,NULL,9,15/12/2020,NULL
252032,175637,7,27/06/2021,5371854,923343,857023,66319,4448511,N,NULL,9,15/12/2020,NULL
252033,175637,8,27/07/2021,4504118,923343,867736,55606,3580775,N,NULL,9,15/12/2020,NULL
252034,175637,9,27/08/2021,3625535,923343,878583,44760,2702192,N,NULL,9,15/12/2020,NULL
252035,175637,10,27/09/2021,2735970,923343,889565,33777,1812627,N,NULL,9,15/12/2020,NULL
252036,175637,11,27/10/2021,1835285,923343,900685,22658,911942,N,NULL,9,15/12/2020,NULL
252037,175637,12,27/11/2021,923342,923343,911942,11399,0,N,NULL,9,15/12/2020,NULL
252038,175638,1,30/12/2020,16200000,510743,310743,200000,15689257,N,NULL,9,15/12/2020,NULL
252039,175638,2,30/01/2021,15885373,510743,314627,196116,15374630,N,NULL,9,15/12/2020,NULL
252040,175638,3,28/02/2021,15566813,510743,318560,192183,15056070,N,NULL,9,15/12/2020,NULL
252041,175638,4,28/03/2021,15244271,510743,322542,188201,14733528,N,NULL,9,15/12/2020,NULL
252042,175638,5,28/04/2021,14917697,510743,326574,184169,14406954,N,NULL,9,15/12/2020,NULL
252043,175638,6,28/05/2021,14587041,510743,330656,180087,14076298,N,NULL,9,15/12/2020,NULL
252044,175638,7,28/06/2021,14252252,510743,334789,175954,13741509,N,NULL,9,15/12/2020,NULL
252045,175638,8,28/07/2021,13913278,510743,338974,171769,13402535,N,NULL,9,15/12/2020,NULL
252046,175638,9,28/08/2021,13570067,510743,343211,167532,13059324,N,NULL,9,15/12/2020,NULL
252047,175638,10,28/09/2021,13222566,510743,347501,163242,12711823,N,NULL,9,15/12/2020,NULL
252048,175638,11,28/10/2021,12870721,510743,351845,158898,12359978,N,NULL,9,15/12/2020,NULL
252049,175638,12,28/11/2021,12514478,510743,356243,154500,12003735,N,NULL,9,15/12/2020,NULL
252050,175638,13,28/12/2021,12153782,510743,360696,150047,11643039,N,NULL,9,15/12/2020,NULL
252051,175638,14,28/01/2022,11788577,510743,365205,145538,11277834,N,NULL,9,15/12/2020,NULL
252052,175638,15,28/02/2022,11418807,510743,369770,140973,10908064,N,NULL,9,15/12/2020,NULL
252053,175638,16,28/03/2022,11044415,510743,374392,136351,10533672,N,NULL,9,15/12/2020,NULL
252054,175638,17,28/04/2022,10665343,510743,379072,131671,10154600,N,NULL,9,15/12/2020,NULL
252055,175638,18,28/05/2022,10281533,510743,383810,126933,9770790,N,NULL,9,15/12/2020,NULL
252056,175638,19,28/06/2022,9892925,510743,388608,122135,9382182,N,NULL,9,15/12/2020,NULL
252057,175638,20,28/07/2022,9499460,510743,393465,117277,8988717,N,NULL,9,15/12/2020,NULL
252058,175638,21,28/08/2022,9101076,510743,398384,112359,8590333,N,NULL,9,15/12/2020,NULL
252059,175638,22,28/09/2022,8697713,510743,403363,107379,8186970,N,NULL,9,15/12/2020,NULL
252060,175638,23,28/10/2022,8289308,510743,408405,102337,7778565,N,NULL,9,15/12/2020,NULL
252061,175638,24,28/11/2022,7875797,510743,413511,97232,7365054,N,NULL,9,15/12/2020,NULL
252062,175638,25,28/12/2022,7457118,510743,418679,92063,6946375,N,NULL,9,15/12/2020,NULL
252063,175638,26,28/01/2023,7033205,510743,423913,86830,6522462,N,NULL,9,15/12/2020,NULL
252064,175638,27,28/02/2023,6603993,510743,429212,81531,6093250,N,NULL,9,15/12/2020,NULL
252065,175638,28,28/03/2023,6169416,510743,434577,76166,5658673,N,NULL,9,15/12/2020,NULL
252066,175638,29,28/04/2023,5729407,510743,440009,70733,5218664,N,NULL,9,15/12/2020,NULL
252067,175638,30,28/05/2023,5283898,510743,445509,65233,4773155,N,NULL,9,15/12/2020,NULL
252068,175638,31,28/06/2023,4832820,510743,451078,59664,4322077,N,NULL,9,15/12/2020,NULL
252069,175638,32,28/07/2023,4376103,510743,456717,54026,3865360,N,NULL,9,15/12/2020,NULL
252070,175638,33,28/08/2023,3913677,510743,462426,48317,3402934,N,NULL,9,15/12/2020,NULL
252071,175638,34,28/09/2023,3445471,510743,468206,42537,2934728,N,NULL,9,15/12/2020,NULL
252072,175638,35,28/10/2023,2971413,510743,474058,36684,2460670,N,NULL,9,15/12/2020,NULL
252073,175638,36,28/11/2023,2491429,510743,479984,30758,1980686,N,NULL,9,15/12/2020,NULL
252074,175638,37,28/12/2023,2005445,510743,485984,24759,1494702,N,NULL,9,15/12/2020,NULL
252075,175638,38,28/01/2024,1513386,510743,492059,18684,1002643,N,NULL,9,15/12/2020,NULL
252076,175638,39,28/02/2024,1015176,510743,498210,12533,504433,N,NULL,9,15/12/2020,NULL
252077,175638,40,28/03/2024,510739,510743,504433,6305,0,N,NULL,9,15/12/2020,NULL
252078,175639,1,30/12/2020,8100000,387893,287893,100000,7712107,N,NULL,9,15/12/2020,NULL
252079,175639,2,30/01/2021,7808508,387893,291492,96401,7420615,N,NULL,9,15/12/2020,NULL
252080,175639,3,28/02/2021,7513373,387893,295135,92758,7125480,N,NULL,9,15/12/2020,NULL
252081,175639,4,28/03/2021,7214548,387893,298825,89068,6826655,N,NULL,9,15/12/2020,NULL
252082,175639,5,28/04/2021,6911988,387893,302560,85333,6524095,N,NULL,9,15/12/2020,NULL
252083,175639,6,28/05/2021,6605646,387893,306342,81551,6217753,N,NULL,9,15/12/2020,NULL
252084,175639,7,28/06/2021,6295475,387893,310171,77722,5907582,N,NULL,9,15/12/2020,NULL
252085,175639,8,28/07/2021,5981427,387893,314048,73845,5593534,N,NULL,9,15/12/2020,NULL
252086,175639,9,28/08/2021,5663453,387893,317974,69919,5275560,N,NULL,9,15/12/2020,NULL
252087,175639,10,28/09/2021,5341504,387893,321949,65944,4953611,N,NULL,9,15/12/2020,NULL
252088,175639,11,28/10/2021,5015531,387893,325973,61920,4627638,N,NULL,9,15/12/2020,NULL
252089,175639,12,28/11/2021,4685483,387893,330048,57845,4297590,N,NULL,9,15/12/2020,NULL
252090,175639,13,28/12/2021,4351310,387893,334173,53720,3963417,N,NULL,9,15/12/2020,NULL
252091,175639,14,28/01/2022,4012960,387893,338350,49543,3625067,N,NULL,9,15/12/2020,NULL
252092,175639,15,28/02/2022,3670380,387893,342580,45313,3282487,N,NULL,9,15/12/2020,NULL
252093,175639,16,28/03/2022,3323518,387893,346862,41031,2935625,N,NULL,9,15/12/2020,NULL
252094,175639,17,28/04/2022,2972320,387893,351198,36695,2584427,N,NULL,9,15/12/2020,NULL
252095,175639,18,28/05/2022,2616732,387893,355588,32305,2228839,N,NULL,9,15/12/2020,NULL
252096,175639,19,28/06/2022,2256699,387893,360033,27860,1868806,N,NULL,9,15/12/2020,NULL
252097,175639,20,28/07/2022,1892166,387893,364533,23360,1504273,N,NULL,9,15/12/2020,NULL
252098,175639,21,28/08/2022,1523076,387893,369090,18803,1135183,N,NULL,9,15/12/2020,NULL
252099,175639,22,28/09/2022,1149373,387893,373703,14190,761480,N,NULL,9,15/12/2020,NULL
252100,175639,23,28/10/2022,770998,387893,378375,9518,383105,N,NULL,9,15/12/2020,NULL
252101,175639,24,28/11/2022,387894,387893,383105,4789,0,N,NULL,9,15/12/2020,NULL
252102,175640,1,30/12/2020,8100000,190319,90319,100000,7909681,N,NULL,9,15/12/2020,NULL
252103,175640,2,30/01/2021,8008552,190319,91448,98871,7818233,N,NULL,9,15/12/2020,NULL
252104,175640,3,28/02/2021,7915960,190319,92592,97728,7725641,N,NULL,9,15/12/2020,NULL
252105,175640,4,28/03/2021,7822211,190319,93749,96571,7631892,N,NULL,9,15/12/2020,NULL
252106,175640,5,28/04/2021,7727290,190319,94921,95399,7536971,N,NULL,9,15/12/2020,NULL
252107,175640,6,28/05/2021,7631183,190319,96107,94212,7440864,N,NULL,9,15/12/2020,NULL
252108,175640,7,28/06/2021,7533874,190319,97309,93011,7343555,N,NULL,9,15/12/2020,NULL
252109,175640,8,28/07/2021,7435349,190319,98525,91794,7245030,N,NULL,9,15/12/2020,NULL
252110,175640,9,28/08/2021,7335592,190319,99757,90563,7145273,N,NULL,9,15/12/2020,NULL
252111,175640,10,28/09/2021,7234588,190319,101004,89316,7044269,N,NULL,9,15/12/2020,NULL
252112,175640,11,28/10/2021,7132322,190319,102266,88053,6942003,N,NULL,9,15/12/2020,NULL
252113,175640,12,28/11/2021,7028778,190319,103544,86775,6838459,N,NULL,9,15/12/2020,NULL
252114,175640,13,28/12/2021,6923939,190319,104839,85481,6733620,N,NULL,9,15/12/2020,NULL
252115,175640,14,28/01/2022,6817790,190319,106149,84170,6627471,N,NULL,9,15/12/2020,NULL
252116,175640,15,28/02/2022,6710314,190319,107476,82843,6519995,N,NULL,9,15/12/2020,NULL
252117,175640,16,28/03/2022,6601495,190319,108819,81500,6411176,N,NULL,9,15/12/2020,NULL
252118,175640,17,28/04/2022,6491315,190319,110180,80140,6300996,N,NULL,9,15/12/2020,NULL
252119,175640,18,28/05/2022,6379758,190319,111557,78762,6189439,N,NULL,9,15/12/2020,NULL
252120,175640,19,28/06/2022,6266807,190319,112951,77368,6076488,N,NULL,9,15/12/2020,NULL
252121,175640,20,28/07/2022,6152444,190319,114363,75956,5962125,N,NULL,9,15/12/2020,NULL
252122,175640,21,28/08/2022,6036651,190319,115793,74527,5846332,N,NULL,9,15/12/2020,NULL
252123,175640,22,28/09/2022,5919411,190319,117240,73079,5729092,N,NULL,9,15/12/2020,NULL
252124,175640,23,28/10/2022,5800705,190319,118706,71614,5610386,N,NULL,9,15/12/2020,NULL
252125,175640,24,28/11/2022,5680515,190319,120190,70130,5490196,N,NULL,9,15/12/2020,NULL
252126,175640,25,28/12/2022,5558823,190319,121692,68627,5368504,N,NULL,9,15/12/2020,NULL
252127,175640,26,28/01/2023,5435610,190319,123213,67106,5245291,N,NULL,9,15/12/2020,NULL
252128,175640,27,28/02/2023,5310857,190319,124753,65566,5120538,N,NULL,9,15/12/2020,NULL
252129,175640,28,28/03/2023,5184544,190319,126313,64007,4994225,N,NULL,9,15/12/2020,NULL
252130,175640,29,28/04/2023,5056652,190319,127892,62428,4866333,N,NULL,9,15/12/2020,NULL
252131,175640,30,28/05/2023,4927162,190319,129490,60829,4736843,N,NULL,9,15/12/2020,NULL
252132,175640,31,28/06/2023,4796053,190319,131109,59211,4605734,N,NULL,9,15/12/2020,NULL
252133,175640,32,28/07/2023,4663305,190319,132748,57572,4472986,N,NULL,9,15/12/2020,NULL
252134,175640,33,28/08/2023,4528898,190319,134407,55912,4338579,N,NULL,9,15/12/2020,NULL
252135,175640,34,28/09/2023,4392811,190319,136087,54232,4202492,N,NULL,9,15/12/2020,NULL
252136,175640,35,28/10/2023,4255023,190319,137788,52531,4064704,N,NULL,9,15/12/2020,NULL
252137,175640,36,28/11/2023,4115512,190319,139511,50809,3925193,N,NULL,9,15/12/2020,NULL
252138,175640,37,28/12/2023,3974257,190319,141255,49065,3783938,N,NULL,9,15/12/2020,NULL
252139,175640,38,28/01/2024,3831237,190319,143020,47299,3640918,N,NULL,9,15/12/2020,NULL
252140,175640,39,28/02/2024,3686429,190319,144808,45511,3496110,N,NULL,9,15/12/2020,NULL
252141,175640,40,28/03/2024,3539811,190319,146618,43701,3349492,N,NULL,9,15/12/2020,NULL
252142,175640,41,28/04/2024,3391360,190319,148451,41869,3201041,N,NULL,9,15/12/2020,NULL
252143,175640,42,28/05/2024,3241054,190319,150306,40013,3050735,N,NULL,9,15/12/2020,NULL
252144,175640,43,28/06/2024,3088869,190319,152185,38134,2898550,N,NULL,9,15/12/2020,NULL
252145,175640,44,28/07/2024,2934781,190319,154088,36232,2744462,N,NULL,9,15/12/2020,NULL
252146,175640,45,28/08/2024,2778767,190319,156014,34306,2588448,N,NULL,9,15/12/2020,NULL
252147,175640,46,28/09/2024,2620803,190319,157964,32356,2430484,N,NULL,9,15/12/2020,NULL
252148,175640,47,28/10/2024,2460865,190319,159938,30381,2270546,N,NULL,9,15/12/2020,NULL
252149,175640,48,28/11/2024,2298927,190319,161938,28382,2108608,N,NULL,9,15/12/2020,NULL
252150,175640,49,28/12/2024,2134965,190319,163962,26358,1944646,N,NULL,9,15/12/2020,NULL
252151,175640,50,28/01/2025,1968954,190319,166011,24308,1778635,N,NULL,9,15/12/2020,NULL
252152,175640,51,28/02/2025,1800868,190319,168086,22233,1610549,N,NULL,9,15/12/2020,NULL
252153,175640,52,28/03/2025,1630680,190319,170188,20132,1440361,N,NULL,9,15/12/2020,NULL
252154,175640,53,28/04/2025,1458365,190319,172315,18005,1268046,N,NULL,9,15/12/2020,NULL
252155,175640,54,28/05/2025,1283896,190319,174469,15851,1093577,N,NULL,9,15/12/2020,NULL
252156,175640,55,28/06/2025,1107246,190319,176650,13670,916927,N,NULL,9,15/12/2020,NULL
252157,175640,56,28/07/2025,928388,190319,178858,11462,738069,N,NULL,9,15/12/2020,NULL
252158,175640,57,28/08/2025,747294,190319,181094,9226,556975,N,NULL,9,15/12/2020,NULL
252159,175640,58,28/09/2025,563937,190319,183357,6962,373618,N,NULL,9,15/12/2020,NULL
252160,175640,59,28/10/2025,378288,190319,185649,4670,187969,N,NULL,9,15/12/2020,NULL
252161,175640,60,28/11/2025,190318,190319,187969,2350,0,N,NULL,9,15/12/2020,NULL
252162,175641,1,30/12/2020,24300000,570958,270958,300000,23729042,N,NULL,9,15/12/2020,NULL
252163,175641,2,30/01/2021,24025655,570958,274345,296613,23454697,N,NULL,9,15/12/2020,NULL
252164,175641,3,28/02/2021,23747880,570958,277775,293184,23176922,N,NULL,9,15/12/2020,NULL
252165,175641,4,28/03/2021,23466633,570958,281247,289712,22895675,N,NULL,9,15/12/2020,NULL
252166,175641,5,28/04/2021,23181871,570958,284762,286196,22610913,N,NULL,9,15/12/2020,NULL
252167,175641,6,28/05/2021,22893549,570958,288322,282636,22322591,N,NULL,9,15/12/2020,NULL
252168,175641,7,28/06/2021,22601623,570958,291926,279032,22030665,N,NULL,9,15/12/2020,NULL
252169,175641,8,28/07/2021,22306048,570958,295575,275383,21735090,N,NULL,9,15/12/2020,NULL
252170,175641,9,28/08/2021,22006778,570958,299270,271689,21435820,N,NULL,9,15/12/2020,NULL
252171,175641,10,28/09/2021,21703767,570958,303011,267948,21132809,N,NULL,9,15/12/2020,NULL
252172,175641,11,28/10/2021,21396969,570958,306798,264160,20826011,N,NULL,9,15/12/2020,NULL
252173,175641,12,28/11/2021,21086336,570958,310633,260325,20515378,N,NULL,9,15/12/2020,NULL
252174,175641,13,28/12/2021,20771820,570958,314516,256442,20200862,N,NULL,9,15/12/2020,NULL
252175,175641,14,28/01/2022,20453372,570958,318448,252511,19882414,N,NULL,9,15/12/2020,NULL
252176,175641,15,28/02/2022,20130944,570958,322428,248530,19559986,N,NULL,9,15/12/2020,NULL
252177,175641,16,28/03/2022,19804486,570958,326458,244500,19233528,N,NULL,9,15/12/2020,NULL
252178,175641,17,28/04/2022,19473947,570958,330539,240419,18902989,N,NULL,9,15/12/2020,NULL
252179,175641,18,28/05/2022,19139276,570958,334671,236287,18568318,N,NULL,9,15/12/2020,NULL
252180,175641,19,28/06/2022,18800422,570958,338854,232104,18229464,N,NULL,9,15/12/2020,NULL
252181,175641,20,28/07/2022,18457332,570958,343090,227868,17886374,N,NULL,9,15/12/2020,NULL
252182,175641,21,28/08/2022,18109953,570958,347379,223580,17538995,N,NULL,9,15/12/2020,NULL
252183,175641,22,28/09/2022,17758232,570958,351721,219237,17187274,N,NULL,9,15/12/2020,NULL
252184,175641,23,28/10/2022,17402115,570958,356117,214841,16831157,N,NULL,9,15/12/2020,NULL
252185,175641,24,28/11/2022,17041546,570958,360569,210389,16470588,N,NULL,9,15/12/2020,NULL
252186,175641,25,28/12/2022,16676470,570958,365076,205882,16105512,N,NULL,9,15/12/2020,NULL
252187,175641,26,28/01/2023,16306831,570958,369639,201319,15735873,N,NULL,9,15/12/2020,NULL
252188,175641,27,28/02/2023,15932571,570958,374260,196698,15361613,N,NULL,9,15/12/2020,NULL
252189,175641,28,28/03/2023,15553633,570958,378938,192020,14982675,N,NULL,9,15/12/2020,NULL
252190,175641,29,28/04/2023,15169958,570958,383675,187283,14599000,N,NULL,9,15/12/2020,NULL
252191,175641,30,28/05/2023,14781487,570958,388471,182487,14210529,N,NULL,9,15/12/2020,NULL
252192,175641,31,28/06/2023,14388160,570958,393327,177632,13817202,N,NULL,9,15/12/2020,NULL
252193,175641,32,28/07/2023,13989917,570958,398243,172715,13418959,N,NULL,9,15/12/2020,NULL
252194,175641,33,28/08/2023,13586696,570958,403221,167737,13015738,N,NULL,9,15/12/2020,NULL
252195,175641,34,28/09/2023,13178434,570958,408262,162697,12607476,N,NULL,9,15/12/2020,NULL
252196,175641,35,28/10/2023,12765069,570958,413365,157593,12194111,N,NULL,9,15/12/2020,NULL
252197,175641,36,28/11/2023,12346537,570958,418532,152426,11775579,N,NULL,9,15/12/2020,NULL
252198,175641,37,28/12/2023,11922773,570958,423764,147195,11351815,N,NULL,9,15/12/2020,NULL
252199,175641,38,28/01/2024,11493712,570958,429061,141898,10922754,N,NULL,9,15/12/2020,NULL
252200,175641,39,28/02/2024,11059288,570958,434424,136534,10488330,N,NULL,9,15/12/2020,NULL
252201,175641,40,28/03/2024,10619434,570958,439854,131104,10048476,N,NULL,9,15/12/2020,NULL
252202,175641,41,28/04/2024,10174082,570958,445352,125606,9603124,N,NULL,9,15/12/2020,NULL
252203,175641,42,28/05/2024,9723163,570958,450919,120039,9152205,N,NULL,9,15/12/2020,NULL
252204,175641,43,28/06/2024,9266607,570958,456556,114403,8695649,N,NULL,9,15/12/2020,NULL
252205,175641,44,28/07/2024,8804344,570958,462263,108696,8233386,N,NULL,9,15/12/2020,NULL
252206,175641,45,28/08/2024,8336303,570958,468041,102917,7765345,N,NULL,9,15/12/2020,NULL
252207,175641,46,28/09/2024,7862411,570958,473892,97067,7291453,N,NULL,9,15/12/2020,NULL
252208,175641,47,28/10/2024,7382596,570958,479815,91143,6811638,N,NULL,9,15/12/2020,NULL
252209,175641,48,28/11/2024,6896783,570958,485813,85145,6325825,N,NULL,9,15/12/2020,NULL
252210,175641,49,28/12/2024,6404897,570958,491886,79073,5833939,N,NULL,9,15/12/2020,NULL
252211,175641,50,28/01/2025,5906863,570958,498034,72924,5335905,N,NULL,9,15/12/2020,NULL
252212,175641,51,28/02/2025,5402604,570958,504259,66699,4831646,N,NULL,9,15/12/2020,NULL
252213,175641,52,28/03/2025,4892041,570958,510563,60396,4321083,N,NULL,9,15/12/2020,NULL
252214,175641,53,28/04/2025,4375096,570958,516945,54014,3804138,N,NULL,9,15/12/2020,NULL
252215,175641,54,28/05/2025,3851689,570958,523407,47552,3280731,N,NULL,9,15/12/2020,NULL
252216,175641,55,28/06/2025,3321740,570958,529949,41009,2750782,N,NULL,9,15/12/2020,NULL
252217,175641,56,28/07/2025,2785166,570958,536574,34385,2214208,N,NULL,9,15/12/2020,NULL
252218,175641,57,28/08/2025,2241885,570958,543281,27678,1670927,N,NULL,9,15/12/2020,NULL
252219,175641,58,28/09/2025,1691813,570958,550072,20887,1120855,N,NULL,9,15/12/2020,NULL
252220,175641,59,28/10/2025,1134865,570958,556948,14011,563907,N,NULL,9,15/12/2020,NULL
252221,175641,60,28/11/2025,570956,570958,563907,7049,0,N,NULL,9,15/12/2020,NULL
252222,175642,1,30/12/2020,16200000,445292,245292,200000,15754708,N,NULL,9,15/12/2020,NULL
252223,175642,2,30/01/2021,15951642,445292,248358,196934,15506350,N,NULL,9,15/12/2020,NULL
252224,175642,3,28/02/2021,15700179,445292,251463,193829,15254887,N,NULL,9,15/12/2020,NULL
252225,175642,4,28/03/2021,15445573,445292,254606,190686,15000281,N,NULL,9,15/12/2020,NULL
252226,175642,5,28/04/2021,15187785,445292,257788,187504,14742493,N,NULL,9,15/12/2020,NULL
252227,175642,6,28/05/2021,14926774,445292,261011,184281,14481482,N,NULL,9,15/12/2020,NULL
252228,175642,7,28/06/2021,14662501,445292,264273,181019,14217209,N,NULL,9,15/12/2020,NULL
252229,175642,8,28/07/2021,14394924,445292,267577,177715,13949632,N,NULL,9,15/12/2020,NULL
252230,175642,9,28/08/2021,14124002,445292,270922,174370,13678710,N,NULL,9,15/12/2020,NULL
252231,175642,10,28/09/2021,13849694,445292,274308,170984,13404402,N,NULL,9,15/12/2020,NULL
252232,175642,11,28/10/2021,13571957,445292,277737,167555,13126665,N,NULL,9,15/12/2020,NULL
252233,175642,12,28/11/2021,13290748,445292,281209,164083,12845456,N,NULL,9,15/12/2020,NULL
252234,175642,13,28/12/2021,13006024,445292,284724,160568,12560732,N,NULL,9,15/12/2020,NULL
252235,175642,14,28/01/2022,12717741,445292,288283,157009,12272449,N,NULL,9,15/12/2020,NULL
252236,175642,15,28/02/2022,12425855,445292,291886,153406,11980563,N,NULL,9,15/12/2020,NULL
252237,175642,16,28/03/2022,12130320,445292,295535,149757,11685028,N,NULL,9,15/12/2020,NULL
252238,175642,17,28/04/2022,11831091,445292,299229,146063,11385799,N,NULL,9,15/12/2020,NULL
252239,175642,18,28/05/2022,11528122,445292,302969,142322,11082830,N,NULL,9,15/12/2020,NULL
252240,175642,19,28/06/2022,11221365,445292,306757,138535,10776073,N,NULL,9,15/12/2020,NULL
252241,175642,20,28/07/2022,10910774,445292,310591,134701,10465482,N,NULL,9,15/12/2020,NULL
252242,175642,21,28/08/2022,10596301,445292,314473,130819,10151009,N,NULL,9,15/12/2020,NULL
252243,175642,22,28/09/2022,10277897,445292,318404,126888,9832605,N,NULL,9,15/12/2020,NULL
252244,175642,23,28/10/2022,9955513,445292,322384,122908,9510221,N,NULL,9,15/12/2020,NULL
252245,175642,24,28/11/2022,9629099,445292,326414,118878,9183807,N,NULL,9,15/12/2020,NULL
252246,175642,25,28/12/2022,9298605,445292,330494,114798,8853313,N,NULL,9,15/12/2020,NULL
252247,175642,26,28/01/2023,8963979,445292,334626,110666,8518687,N,NULL,9,15/12/2020,NULL
252248,175642,27,28/02/2023,8625171,445292,338808,106484,8179879,N,NULL,9,15/12/2020,NULL
252249,175642,28,28/03/2023,8282127,445292,343044,102248,7836835,N,NULL,9,15/12/2020,NULL
252250,175642,29,28/04/2023,7934795,445292,347332,97960,7489503,N,NULL,9,15/12/2020,NULL
252251,175642,30,28/05/2023,7583122,445292,351673,93619,7137830,N,NULL,9,15/12/2020,NULL
252252,175642,31,28/06/2023,7227053,445292,356069,89223,6781761,N,NULL,9,15/12/2020,NULL
252253,175642,32,28/07/2023,6866533,445292,360520,84772,6421241,N,NULL,9,15/12/2020,NULL
252254,175642,33,28/08/2023,6501507,445292,365026,80266,6056215,N,NULL,9,15/12/2020,NULL
252255,175642,34,28/09/2023,6131918,445292,369589,75703,5686626,N,NULL,9,15/12/2020,NULL
252256,175642,35,28/10/2023,5757709,445292,374209,71083,5312417,N,NULL,9,15/12/2020,NULL
252257,175642,36,28/11/2023,5378822,445292,378887,66405,4933530,N,NULL,9,15/12/2020,NULL
252258,175642,37,28/12/2023,4995199,445292,383623,61669,4549907,N,NULL,9,15/12/2020,NULL
252259,175642,38,28/01/2024,4606781,445292,388418,56874,4161489,N,NULL,9,15/12/2020,NULL
252260,175642,39,28/02/2024,4213508,445292,393273,52019,3768216,N,NULL,9,15/12/2020,NULL
252261,175642,40,28/03/2024,3815319,445292,398189,47103,3370027,N,NULL,9,15/12/2020,NULL
252262,175642,41,28/04/2024,3412152,445292,403167,42125,2966860,N,NULL,9,15/12/2020,NULL
252263,175642,42,28/05/2024,3003946,445292,408206,37086,2558654,N,NULL,9,15/12/2020,NULL
252264,175642,43,28/06/2024,2590637,445292,413309,31983,2145345,N,NULL,9,15/12/2020,NULL
252265,175642,44,28/07/2024,2172162,445292,418475,26817,1726870,N,NULL,9,15/12/2020,NULL
252266,175642,45,28/08/2024,1748456,445292,423706,21586,1303164,N,NULL,9,15/12/2020,NULL
252267,175642,46,28/09/2024,1319454,445292,429002,16290,874162,N,NULL,9,15/12/2020,NULL
252268,175642,47,28/10/2024,885089,445292,434365,10927,439797,N,NULL,9,15/12/2020,NULL
252269,175642,48,28/11/2024,445294,445292,439797,5497,0,N,NULL,9,15/12/2020,NULL
252270,175643,1,30/12/2020,16200000,380639,180639,200000,15819361,N,NULL,9,15/12/2020,NULL
252271,175643,2,30/01/2021,16017103,380639,182897,197742,15636464,N,NULL,9,15/12/2020,NULL
252272,175643,3,28/02/2021,15831920,380639,185183,195456,15451281,N,NULL,9,15/12/2020,NULL
252273,175643,4,28/03/2021,15644422,380639,187498,193141,15263783,N,NULL,9,15/12/2020,NULL
252274,175643,5,28/04/2021,15454580,380639,189842,190797,15073941,N,NULL,9,15/12/2020,NULL
252275,175643,6,28/05/2021,15262365,380639,192215,188424,14881726,N,NULL,9,15/12/2020,NULL
252276,175643,7,28/06/2021,15067748,380639,194617,186022,14687109,N,NULL,9,15/12/2020,NULL
252277,175643,8,28/07/2021,14870698,380639,197050,183589,14490059,N,NULL,9,15/12/2020,NULL
252278,175643,9,28/08/2021,14671185,380639,199513,181126,14290546,N,NULL,9,15/12/2020,NULL
252279,175643,10,28/09/2021,14469178,380639,202007,178632,14088539,N,NULL,9,15/12/2020,NULL
252280,175643,11,28/10/2021,14264646,380639,204532,176107,13884007,N,NULL,9,15/12/2020,NULL
252281,175643,12,28/11/2021,14057557,380639,207089,173550,13676918,N,NULL,9,15/12/2020,NULL
252282,175643,13,28/12/2021,13847880,380639,209677,170961,13467241,N,NULL,9,15/12/2020,NULL
252283,175643,14,28/01/2022,13635582,380639,212298,168341,13254943,N,NULL,9,15/12/2020,NULL
252284,175643,15,28/02/2022,13420630,380639,214952,165687,13039991,N,NULL,9,15/12/2020,NULL
252285,175643,16,28/03/2022,13202991,380639,217639,163000,12822352,N,NULL,9,15/12/2020,NULL
252286,175643,17,28/04/2022,12982632,380639,220359,160279,12601993,N,NULL,9,15/12/2020,NULL
252287,175643,18,28/05/2022,12759518,380639,223114,157525,12378879,N,NULL,9,15/12/2020,NULL
252288,175643,19,28/06/2022,12533615,380639,225903,154736,12152976,N,NULL,9,15/12/2020,NULL
252289,175643,20,28/07/2022,12304888,380639,228727,151912,11924249,N,NULL,9,15/12/2020,NULL
252290,175643,21,28/08/2022,12073302,380639,231586,149053,11692663,N,NULL,9,15/12/2020,NULL
252291,175643,22,28/09/2022,11838821,380639,234481,146158,11458182,N,NULL,9,15/12/2020,NULL
252292,175643,23,28/10/2022,11601409,380639,237412,143227,11220770,N,NULL,9,15/12/2020,NULL
252293,175643,24,28/11/2022,11361030,380639,240379,140260,10980391,N,NULL,9,15/12/2020,NULL
252294,175643,25,28/12/2022,11117646,380639,243384,137255,10737007,N,NULL,9,15/12/2020,NULL
252295,175643,26,28/01/2023,10871220,380639,246426,134213,10490581,N,NULL,9,15/12/2020,NULL
252296,175643,27,28/02/2023,10621713,380639,249507,131132,10241074,N,NULL,9,15/12/2020,NULL
252297,175643,28,28/03/2023,10369088,380639,252625,128013,9988449,N,NULL,9,15/12/2020,NULL
252298,175643,29,28/04/2023,10113305,380639,255783,124856,9732666,N,NULL,9,15/12/2020,NULL
252299,175643,30,28/05/2023,9854324,380639,258981,121658,9473685,N,NULL,9,15/12/2020,NULL
252300,175643,31,28/06/2023,9592106,380639,262218,118421,9211467,N,NULL,9,15/12/2020,NULL
252301,175643,32,28/07/2023,9326610,380639,265496,115143,8945971,N,NULL,9,15/12/2020,NULL
252302,175643,33,28/08/2023,9057796,380639,268814,111825,8677157,N,NULL,9,15/12/2020,NULL
252303,175643,34,28/09/2023,8785622,380639,272174,108464,8404983,N,NULL,9,15/12/2020,NULL
252304,175643,35,28/10/2023,8510045,380639,275577,105062,8129406,N,NULL,9,15/12/2020,NULL
252305,175643,36,28/11/2023,8231024,380639,279021,101618,7850385,N,NULL,9,15/12/2020,NULL
252306,175643,37,28/12/2023,7948515,380639,282509,98130,7567876,N,NULL,9,15/12/2020,NULL
252307,175643,38,28/01/2024,7662475,380639,286040,94598,7281836,N,NULL,9,15/12/2020,NULL
252308,175643,39,28/02/2024,7372859,380639,289616,91023,6992220,N,NULL,9,15/12/2020,NULL
252309,175643,40,28/03/2024,7079623,380639,293236,87403,6698984,N,NULL,9,15/12/2020,NULL
252310,175643,41,28/04/2024,6782721,380639,296902,83737,6402082,N,NULL,9,15/12/2020,NULL
252311,175643,42,28/05/2024,6482108,380639,300613,80026,6101469,N,NULL,9,15/12/2020,NULL
252312,175643,43,28/06/2024,6177737,380639,304371,76268,5797098,N,NULL,9,15/12/2020,NULL
252313,175643,44,28/07/2024,5869562,380639,308175,72464,5488923,N,NULL,9,15/12/2020,NULL
252314,175643,45,28/08/2024,5557535,380639,312027,68612,5176896,N,NULL,9,15/12/2020,NULL
252315,175643,46,28/09/2024,5241607,380639,315928,64711,4860968,N,NULL,9,15/12/2020,NULL
252316,175643,47,28/10/2024,4921730,380639,319877,60762,4541091,N,NULL,9,15/12/2020,NULL
252317,175643,48,28/11/2024,4597855,380639,323875,56764,4217216,N,NULL,9,15/12/2020,NULL
252318,175643,49,28/12/2024,4269931,380639,327924,52715,3889292,N,NULL,9,15/12/2020,NULL
252319,175643,50,28/01/2025,3937908,380639,332023,48616,3557269,N,NULL,9,15/12/2020,NULL
252320,175643,51,28/02/2025,3601735,380639,336173,44466,3221096,N,NULL,9,15/12/2020,NULL
252321,175643,52,28/03/2025,3261360,380639,340375,40264,2880721,N,NULL,9,15/12/2020,NULL
252322,175643,53,28/04/2025,2916730,380639,344630,36009,2536091,N,NULL,9,15/12/2020,NULL
252323,175643,54,28/05/2025,2567792,380639,348938,31701,2187153,N,NULL,9,15/12/2020,NULL
252324,175643,55,28/06/2025,2214493,380639,353299,27339,1833854,N,NULL,9,15/12/2020,NULL
252325,175643,56,28/07/2025,1856777,380639,357716,22923,1476138,N,NULL,9,15/12/2020,NULL
252326,175643,57,28/08/2025,1494590,380639,362187,18452,1113951,N,NULL,9,15/12/2020,NULL
252327,175643,58,28/09/2025,1127876,380639,366714,13924,747237,N,NULL,9,15/12/2020,NULL
252328,175643,59,28/10/2025,756578,380639,371298,9340,375939,N,NULL,9,15/12/2020,NULL
252329,175643,60,28/11/2025,380638,380639,375939,4699,0,N,NULL,9,15/12/2020,NULL
252330,175644,1,30/12/2020,16200000,445292,245292,200000,15754708,N,NULL,9,15/12/2020,NULL
252331,175644,2,30/01/2021,15951642,445292,248358,196934,15506350,N,NULL,9,15/12/2020,NULL
252332,175644,3,28/02/2021,15700179,445292,251463,193829,15254887,N,NULL,9,15/12/2020,NULL
252333,175644,4,28/03/2021,15445573,445292,254606,190686,15000281,N,NULL,9,15/12/2020,NULL
252334,175644,5,28/04/2021,15187785,445292,257788,187504,14742493,N,NULL,9,15/12/2020,NULL
252335,175644,6,28/05/2021,14926774,445292,261011,184281,14481482,N,NULL,9,15/12/2020,NULL
252336,175644,7,28/06/2021,14662501,445292,264273,181019,14217209,N,NULL,9,15/12/2020,NULL
252337,175644,8,28/07/2021,14394924,445292,267577,177715,13949632,N,NULL,9,15/12/2020,NULL
252338,175644,9,28/08/2021,14124002,445292,270922,174370,13678710,N,NULL,9,15/12/2020,NULL
252339,175644,10,28/09/2021,13849694,445292,274308,170984,13404402,N,NULL,9,15/12/2020,NULL
252340,175644,11,28/10/2021,13571957,445292,277737,167555,13126665,N,NULL,9,15/12/2020,NULL
252341,175644,12,28/11/2021,13290748,445292,281209,164083,12845456,N,NULL,9,15/12/2020,NULL
252342,175644,13,28/12/2021,13006024,445292,284724,160568,12560732,N,NULL,9,15/12/2020,NULL
252343,175644,14,28/01/2022,12717741,445292,288283,157009,12272449,N,NULL,9,15/12/2020,NULL
252344,175644,15,28/02/2022,12425855,445292,291886,153406,11980563,N,NULL,9,15/12/2020,NULL
252345,175644,16,28/03/2022,12130320,445292,295535,149757,11685028,N,NULL,9,15/12/2020,NULL
252346,175644,17,28/04/2022,11831091,445292,299229,146063,11385799,N,NULL,9,15/12/2020,NULL
252347,175644,18,28/05/2022,11528122,445292,302969,142322,11082830,N,NULL,9,15/12/2020,NULL
252348,175644,19,28/06/2022,11221365,445292,306757,138535,10776073,N,NULL,9,15/12/2020,NULL
252349,175644,20,28/07/2022,10910774,445292,310591,134701,10465482,N,NULL,9,15/12/2020,NULL
252350,175644,21,28/08/2022,10596301,445292,314473,130819,10151009,N,NULL,9,15/12/2020,NULL
252351,175644,22,28/09/2022,10277897,445292,318404,126888,9832605,N,NULL,9,15/12/2020,NULL
252352,175644,23,28/10/2022,9955513,445292,322384,122908,9510221,N,NULL,9,15/12/2020,NULL
252353,175644,24,28/11/2022,9629099,445292,326414,118878,9183807,N,NULL,9,15/12/2020,NULL
252354,175644,25,28/12/2022,9298605,445292,330494,114798,8853313,N,NULL,9,15/12/2020,NULL
252355,175644,26,28/01/2023,8963979,445292,334626,110666,8518687,N,NULL,9,15/12/2020,NULL
252356,175644,27,28/02/2023,8625171,445292,338808,106484,8179879,N,NULL,9,15/12/2020,NULL
252357,175644,28,28/03/2023,8282127,445292,343044,102248,7836835,N,NULL,9,15/12/2020,NULL
252358,175644,29,28/04/2023,7934795,445292,347332,97960,7489503,N,NULL,9,15/12/2020,NULL
252359,175644,30,28/05/2023,7583122,445292,351673,93619,7137830,N,NULL,9,15/12/2020,NULL
252360,175644,31,28/06/2023,7227053,445292,356069,89223,6781761,N,NULL,9,15/12/2020,NULL
252361,175644,32,28/07/2023,6866533,445292,360520,84772,6421241,N,NULL,9,15/12/2020,NULL
252362,175644,33,28/08/2023,6501507,445292,365026,80266,6056215,N,NULL,9,15/12/2020,NULL
252363,175644,34,28/09/2023,6131918,445292,369589,75703,5686626,N,NULL,9,15/12/2020,NULL
252364,175644,35,28/10/2023,5757709,445292,374209,71083,5312417,N,NULL,9,15/12/2020,NULL
252365,175644,36,28/11/2023,5378822,445292,378887,66405,4933530,N,NULL,9,15/12/2020,NULL
252366,175644,37,28/12/2023,4995199,445292,383623,61669,4549907,N,NULL,9,15/12/2020,NULL
252367,175644,38,28/01/2024,4606781,445292,388418,56874,4161489,N,NULL,9,15/12/2020,NULL
252368,175644,39,28/02/2024,4213508,445292,393273,52019,3768216,N,NULL,9,15/12/2020,NULL
252369,175644,40,28/03/2024,3815319,445292,398189,47103,3370027,N,NULL,9,15/12/2020,NULL
252370,175644,41,28/04/2024,3412152,445292,403167,42125,2966860,N,NULL,9,15/12/2020,NULL
252371,175644,42,28/05/2024,3003946,445292,408206,37086,2558654,N,NULL,9,15/12/2020,NULL
252372,175644,43,28/06/2024,2590637,445292,413309,31983,2145345,N,NULL,9,15/12/2020,NULL
252373,175644,44,28/07/2024,2172162,445292,418475,26817,1726870,N,NULL,9,15/12/2020,NULL
252374,175644,45,28/08/2024,1748456,445292,423706,21586,1303164,N,NULL,9,15/12/2020,NULL
252375,175644,46,28/09/2024,1319454,445292,429002,16290,874162,N,NULL,9,15/12/2020,NULL
252376,175644,47,28/10/2024,885089,445292,434365,10927,439797,N,NULL,9,15/12/2020,NULL
252377,175644,48,28/11/2024,445294,445292,439797,5497,0,N,NULL,9,15/12/2020,NULL
252378,175645,1,30/12/2020,24300000,570958,270958,300000,23729042,N,NULL,9,15/12/2020,NULL
252379,175645,2,30/01/2021,24025655,570958,274345,296613,23454697,N,NULL,9,15/12/2020,NULL
252380,175645,3,28/02/2021,23747880,570958,277775,293184,23176922,N,NULL,9,15/12/2020,NULL
252381,175645,4,28/03/2021,23466633,570958,281247,289712,22895675,N,NULL,9,15/12/2020,NULL
252382,175645,5,28/04/2021,23181871,570958,284762,286196,22610913,N,NULL,9,15/12/2020,NULL
252383,175645,6,28/05/2021,22893549,570958,288322,282636,22322591,N,NULL,9,15/12/2020,NULL
252384,175645,7,28/06/2021,22601623,570958,291926,279032,22030665,N,NULL,9,15/12/2020,NULL
252385,175645,8,28/07/2021,22306048,570958,295575,275383,21735090,N,NULL,9,15/12/2020,NULL
252386,175645,9,28/08/2021,22006778,570958,299270,271689,21435820,N,NULL,9,15/12/2020,NULL
252387,175645,10,28/09/2021,21703767,570958,303011,267948,21132809,N,NULL,9,15/12/2020,NULL
252388,175645,11,28/10/2021,21396969,570958,306798,264160,20826011,N,NULL,9,15/12/2020,NULL
252389,175645,12,28/11/2021,21086336,570958,310633,260325,20515378,N,NULL,9,15/12/2020,NULL
252390,175645,13,28/12/2021,20771820,570958,314516,256442,20200862,N,NULL,9,15/12/2020,NULL
252391,175645,14,28/01/2022,20453372,570958,318448,252511,19882414,N,NULL,9,15/12/2020,NULL
252392,175645,15,28/02/2022,20130944,570958,322428,248530,19559986,N,NULL,9,15/12/2020,NULL
252393,175645,16,28/03/2022,19804486,570958,326458,244500,19233528,N,NULL,9,15/12/2020,NULL
252394,175645,17,28/04/2022,19473947,570958,330539,240419,18902989,N,NULL,9,15/12/2020,NULL
252395,175645,18,28/05/2022,19139276,570958,334671,236287,18568318,N,NULL,9,15/12/2020,NULL
252396,175645,19,28/06/2022,18800422,570958,338854,232104,18229464,N,NULL,9,15/12/2020,NULL
252397,175645,20,28/07/2022,18457332,570958,343090,227868,17886374,N,NULL,9,15/12/2020,NULL
252398,175645,21,28/08/2022,18109953,570958,347379,223580,17538995,N,NULL,9,15/12/2020,NULL
252399,175645,22,28/09/2022,17758232,570958,351721,219237,17187274,N,NULL,9,15/12/2020,NULL
252400,175645,23,28/10/2022,17402115,570958,356117,214841,16831157,N,NULL,9,15/12/2020,NULL
252401,175645,24,28/11/2022,17041546,570958,360569,210389,16470588,N,NULL,9,15/12/2020,NULL
252402,175645,25,28/12/2022,16676470,570958,365076,205882,16105512,N,NULL,9,15/12/2020,NULL
252403,175645,26,28/01/2023,16306831,570958,369639,201319,15735873,N,NULL,9,15/12/2020,NULL
252404,175645,27,28/02/2023,15932571,570958,374260,196698,15361613,N,NULL,9,15/12/2020,NULL
252405,175645,28,28/03/2023,15553633,570958,378938,192020,14982675,N,NULL,9,15/12/2020,NULL
252406,175645,29,28/04/2023,15169958,570958,383675,187283,14599000,N,NULL,9,15/12/2020,NULL
252407,175645,30,28/05/2023,14781487,570958,388471,182487,14210529,N,NULL,9,15/12/2020,NULL
252408,175645,31,28/06/2023,14388160,570958,393327,177632,13817202,N,NULL,9,15/12/2020,NULL
252409,175645,32,28/07/2023,13989917,570958,398243,172715,13418959,N,NULL,9,15/12/2020,NULL
252410,175645,33,28/08/2023,13586696,570958,403221,167737,13015738,N,NULL,9,15/12/2020,NULL
252411,175645,34,28/09/2023,13178434,570958,408262,162697,12607476,N,NULL,9,15/12/2020,NULL
252412,175645,35,28/10/2023,12765069,570958,413365,157593,12194111,N,NULL,9,15/12/2020,NULL
252413,175645,36,28/11/2023,12346537,570958,418532,152426,11775579,N,NULL,9,15/12/2020,NULL
252414,175645,37,28/12/2023,11922773,570958,423764,147195,11351815,N,NULL,9,15/12/2020,NULL
252415,175645,38,28/01/2024,11493712,570958,429061,141898,10922754,N,NULL,9,15/12/2020,NULL
252416,175645,39,28/02/2024,11059288,570958,434424,136534,10488330,N,NULL,9,15/12/2020,NULL
252417,175645,40,28/03/2024,10619434,570958,439854,131104,10048476,N,NULL,9,15/12/2020,NULL
252418,175645,41,28/04/2024,10174082,570958,445352,125606,9603124,N,NULL,9,15/12/2020,NULL
252419,175645,42,28/05/2024,9723163,570958,450919,120039,9152205,N,NULL,9,15/12/2020,NULL
252420,175645,43,28/06/2024,9266607,570958,456556,114403,8695649,N,NULL,9,15/12/2020,NULL
252421,175645,44,28/07/2024,8804344,570958,462263,108696,8233386,N,NULL,9,15/12/2020,NULL
252422,175645,45,28/08/2024,8336303,570958,468041,102917,7765345,N,NULL,9,15/12/2020,NULL
252423,175645,46,28/09/2024,7862411,570958,473892,97067,7291453,N,NULL,9,15/12/2020,NULL
252424,175645,47,28/10/2024,7382596,570958,479815,91143,6811638,N,NULL,9,15/12/2020,NULL
252425,175645,48,28/11/2024,6896783,570958,485813,85145,6325825,N,NULL,9,15/12/2020,NULL
252426,175645,49,28/12/2024,6404897,570958,491886,79073,5833939,N,NULL,9,15/12/2020,NULL
252427,175645,50,28/01/2025,5906863,570958,498034,72924,5335905,N,NULL,9,15/12/2020,NULL
252428,175645,51,28/02/2025,5402604,570958,504259,66699,4831646,N,NULL,9,15/12/2020,NULL
252429,175645,52,28/03/2025,4892041,570958,510563,60396,4321083,N,NULL,9,15/12/2020,NULL
252430,175645,53,28/04/2025,4375096,570958,516945,54014,3804138,N,NULL,9,15/12/2020,NULL
252431,175645,54,28/05/2025,3851689,570958,523407,47552,3280731,N,NULL,9,15/12/2020,NULL
252432,175645,55,28/06/2025,3321740,570958,529949,41009,2750782,N,NULL,9,15/12/2020,NULL
252433,175645,56,28/07/2025,2785166,570958,536574,34385,2214208,N,NULL,9,15/12/2020,NULL
252434,175645,57,28/08/2025,2241885,570958,543281,27678,1670927,N,NULL,9,15/12/2020,NULL
252435,175645,58,28/09/2025,1691813,570958,550072,20887,1120855,N,NULL,9,15/12/2020,NULL
252436,175645,59,28/10/2025,1134865,570958,556948,14011,563907,N,NULL,9,15/12/2020,NULL
252437,175645,60,28/11/2025,570956,570958,563907,7049,0,N,NULL,9,15/12/2020,NULL
252438,175646,1,30/12/2020,16200000,445292,245292,200000,15754708,N,NULL,9,15/12/2020,NULL
252439,175646,2,30/01/2021,15951642,445292,248358,196934,15506350,N,NULL,9,15/12/2020,NULL
252440,175646,3,28/02/2021,15700179,445292,251463,193829,15254887,N,NULL,9,15/12/2020,NULL
252441,175646,4,28/03/2021,15445573,445292,254606,190686,15000281,N,NULL,9,15/12/2020,NULL
252442,175646,5,28/04/2021,15187785,445292,257788,187504,14742493,N,NULL,9,15/12/2020,NULL
252443,175646,6,28/05/2021,14926774,445292,261011,184281,14481482,N,NULL,9,15/12/2020,NULL
252444,175646,7,28/06/2021,14662501,445292,264273,181019,14217209,N,NULL,9,15/12/2020,NULL
252445,175646,8,28/07/2021,14394924,445292,267577,177715,13949632,N,NULL,9,15/12/2020,NULL
252446,175646,9,28/08/2021,14124002,445292,270922,174370,13678710,N,NULL,9,15/12/2020,NULL
252447,175646,10,28/09/2021,13849694,445292,274308,170984,13404402,N,NULL,9,15/12/2020,NULL
252448,175646,11,28/10/2021,13571957,445292,277737,167555,13126665,N,NULL,9,15/12/2020,NULL
252449,175646,12,28/11/2021,13290748,445292,281209,164083,12845456,N,NULL,9,15/12/2020,NULL
252450,175646,13,28/12/2021,13006024,445292,284724,160568,12560732,N,NULL,9,15/12/2020,NULL
252451,175646,14,28/01/2022,12717741,445292,288283,157009,12272449,N,NULL,9,15/12/2020,NULL
252452,175646,15,28/02/2022,12425855,445292,291886,153406,11980563,N,NULL,9,15/12/2020,NULL
252453,175646,16,28/03/2022,12130320,445292,295535,149757,11685028,N,NULL,9,15/12/2020,NULL
252454,175646,17,28/04/2022,11831091,445292,299229,146063,11385799,N,NULL,9,15/12/2020,NULL
252455,175646,18,28/05/2022,11528122,445292,302969,142322,11082830,N,NULL,9,15/12/2020,NULL
252456,175646,19,28/06/2022,11221365,445292,306757,138535,10776073,N,NULL,9,15/12/2020,NULL
252457,175646,20,28/07/2022,10910774,445292,310591,134701,10465482,N,NULL,9,15/12/2020,NULL
252458,175646,21,28/08/2022,10596301,445292,314473,130819,10151009,N,NULL,9,15/12/2020,NULL
252459,175646,22,28/09/2022,10277897,445292,318404,126888,9832605,N,NULL,9,15/12/2020,NULL
252460,175646,23,28/10/2022,9955513,445292,322384,122908,9510221,N,NULL,9,15/12/2020,NULL
252461,175646,24,28/11/2022,9629099,445292,326414,118878,9183807,N,NULL,9,15/12/2020,NULL
252462,175646,25,28/12/2022,9298605,445292,330494,114798,8853313,N,NULL,9,15/12/2020,NULL
252463,175646,26,28/01/2023,8963979,445292,334626,110666,8518687,N,NULL,9,15/12/2020,NULL
252464,175646,27,28/02/2023,8625171,445292,338808,106484,8179879,N,NULL,9,15/12/2020,NULL
252465,175646,28,28/03/2023,8282127,445292,343044,102248,7836835,N,NULL,9,15/12/2020,NULL
252466,175646,29,28/04/2023,7934795,445292,347332,97960,7489503,N,NULL,9,15/12/2020,NULL
252467,175646,30,28/05/2023,7583122,445292,351673,93619,7137830,N,NULL,9,15/12/2020,NULL
252468,175646,31,28/06/2023,7227053,445292,356069,89223,6781761,N,NULL,9,15/12/2020,NULL
252469,175646,32,28/07/2023,6866533,445292,360520,84772,6421241,N,NULL,9,15/12/2020,NULL
252470,175646,33,28/08/2023,6501507,445292,365026,80266,6056215,N,NULL,9,15/12/2020,NULL
252471,175646,34,28/09/2023,6131918,445292,369589,75703,5686626,N,NULL,9,15/12/2020,NULL
252472,175646,35,28/10/2023,5757709,445292,374209,71083,5312417,N,NULL,9,15/12/2020,NULL
252473,175646,36,28/11/2023,5378822,445292,378887,66405,4933530,N,NULL,9,15/12/2020,NULL
252474,175646,37,28/12/2023,4995199,445292,383623,61669,4549907,N,NULL,9,15/12/2020,NULL
252475,175646,38,28/01/2024,4606781,445292,388418,56874,4161489,N,NULL,9,15/12/2020,NULL
252476,175646,39,28/02/2024,4213508,445292,393273,52019,3768216,N,NULL,9,15/12/2020,NULL
252477,175646,40,28/03/2024,3815319,445292,398189,47103,3370027,N,NULL,9,15/12/2020,NULL
252478,175646,41,28/04/2024,3412152,445292,403167,42125,2966860,N,NULL,9,15/12/2020,NULL
252479,175646,42,28/05/2024,3003946,445292,408206,37086,2558654,N,NULL,9,15/12/2020,NULL
252480,175646,43,28/06/2024,2590637,445292,413309,31983,2145345,N,NULL,9,15/12/2020,NULL
252481,175646,44,28/07/2024,2172162,445292,418475,26817,1726870,N,NULL,9,15/12/2020,NULL
252482,175646,45,28/08/2024,1748456,445292,423706,21586,1303164,N,NULL,9,15/12/2020,NULL
252483,175646,46,28/09/2024,1319454,445292,429002,16290,874162,N,NULL,9,15/12/2020,NULL
252484,175646,47,28/10/2024,885089,445292,434365,10927,439797,N,NULL,9,15/12/2020,NULL
252485,175646,48,28/11/2024,445294,445292,439797,5497,0,N,NULL,9,15/12/2020,NULL
252486,175647,1,30/12/2020,16200000,380639,180639,200000,15819361,N,NULL,9,15/12/2020,NULL
252487,175647,2,30/01/2021,16017103,380639,182897,197742,15636464,N,NULL,9,15/12/2020,NULL
252488,175647,3,28/02/2021,15831920,380639,185183,195456,15451281,N,NULL,9,15/12/2020,NULL
252489,175647,4,28/03/2021,15644422,380639,187498,193141,15263783,N,NULL,9,15/12/2020,NULL
252490,175647,5,28/04/2021,15454580,380639,189842,190797,15073941,N,NULL,9,15/12/2020,NULL
252491,175647,6,28/05/2021,15262365,380639,192215,188424,14881726,N,NULL,9,15/12/2020,NULL
252492,175647,7,28/06/2021,15067748,380639,194617,186022,14687109,N,NULL,9,15/12/2020,NULL
252493,175647,8,28/07/2021,14870698,380639,197050,183589,14490059,N,NULL,9,15/12/2020,NULL
252494,175647,9,28/08/2021,14671185,380639,199513,181126,14290546,N,NULL,9,15/12/2020,NULL
252495,175647,10,28/09/2021,14469178,380639,202007,178632,14088539,N,NULL,9,15/12/2020,NULL
252496,175647,11,28/10/2021,14264646,380639,204532,176107,13884007,N,NULL,9,15/12/2020,NULL
252497,175647,12,28/11/2021,14057557,380639,207089,173550,13676918,N,NULL,9,15/12/2020,NULL
252498,175647,13,28/12/2021,13847880,380639,209677,170961,13467241,N,NULL,9,15/12/2020,NULL
252499,175647,14,28/01/2022,13635582,380639,212298,168341,13254943,N,NULL,9,15/12/2020,NULL
252500,175647,15,28/02/2022,13420630,380639,214952,165687,13039991,N,NULL,9,15/12/2020,NULL
252501,175647,16,28/03/2022,13202991,380639,217639,163000,12822352,N,NULL,9,15/12/2020,NULL
252502,175647,17,28/04/2022,12982632,380639,220359,160279,12601993,N,NULL,9,15/12/2020,NULL
252503,175647,18,28/05/2022,12759518,380639,223114,157525,12378879,N,NULL,9,15/12/2020,NULL
252504,175647,19,28/06/2022,12533615,380639,225903,154736,12152976,N,NULL,9,15/12/2020,NULL
252505,175647,20,28/07/2022,12304888,380639,228727,151912,11924249,N,NULL,9,15/12/2020,NULL
252506,175647,21,28/08/2022,12073302,380639,231586,149053,11692663,N,NULL,9,15/12/2020,NULL
252507,175647,22,28/09/2022,11838821,380639,234481,146158,11458182,N,NULL,9,15/12/2020,NULL
252508,175647,23,28/10/2022,11601409,380639,237412,143227,11220770,N,NULL,9,15/12/2020,NULL
252509,175647,24,28/11/2022,11361030,380639,240379,140260,10980391,N,NULL,9,15/12/2020,NULL
252510,175647,25,28/12/2022,11117646,380639,243384,137255,10737007,N,NULL,9,15/12/2020,NULL
252511,175647,26,28/01/2023,10871220,380639,246426,134213,10490581,N,NULL,9,15/12/2020,NULL
252512,175647,27,28/02/2023,10621713,380639,249507,131132,10241074,N,NULL,9,15/12/2020,NULL
252513,175647,28,28/03/2023,10369088,380639,252625,128013,9988449,N,NULL,9,15/12/2020,NULL
252514,175647,29,28/04/2023,10113305,380639,255783,124856,9732666,N,NULL,9,15/12/2020,NULL
252515,175647,30,28/05/2023,9854324,380639,258981,121658,9473685,N,NULL,9,15/12/2020,NULL
252516,175647,31,28/06/2023,9592106,380639,262218,118421,9211467,N,NULL,9,15/12/2020,NULL
252517,175647,32,28/07/2023,9326610,380639,265496,115143,8945971,N,NULL,9,15/12/2020,NULL
252518,175647,33,28/08/2023,9057796,380639,268814,111825,8677157,N,NULL,9,15/12/2020,NULL
252519,175647,34,28/09/2023,8785622,380639,272174,108464,8404983,N,NULL,9,15/12/2020,NULL
252520,175647,35,28/10/2023,8510045,380639,275577,105062,8129406,N,NULL,9,15/12/2020,NULL
252521,175647,36,28/11/2023,8231024,380639,279021,101618,7850385,N,NULL,9,15/12/2020,NULL
252522,175647,37,28/12/2023,7948515,380639,282509,98130,7567876,N,NULL,9,15/12/2020,NULL
252523,175647,38,28/01/2024,7662475,380639,286040,94598,7281836,N,NULL,9,15/12/2020,NULL
252524,175647,39,28/02/2024,7372859,380639,289616,91023,6992220,N,NULL,9,15/12/2020,NULL
252525,175647,40,28/03/2024,7079623,380639,293236,87403,6698984,N,NULL,9,15/12/2020,NULL
252526,175647,41,28/04/2024,6782721,380639,296902,83737,6402082,N,NULL,9,15/12/2020,NULL
252527,175647,42,28/05/2024,6482108,380639,300613,80026,6101469,N,NULL,9,15/12/2020,NULL
252528,175647,43,28/06/2024,6177737,380639,304371,76268,5797098,N,NULL,9,15/12/2020,NULL
252529,175647,44,28/07/2024,5869562,380639,308175,72464,5488923,N,NULL,9,15/12/2020,NULL
252530,175647,45,28/08/2024,5557535,380639,312027,68612,5176896,N,NULL,9,15/12/2020,NULL
252531,175647,46,28/09/2024,5241607,380639,315928,64711,4860968,N,NULL,9,15/12/2020,NULL
252532,175647,47,28/10/2024,4921730,380639,319877,60762,4541091,N,NULL,9,15/12/2020,NULL
252533,175647,48,28/11/2024,4597855,380639,323875,56764,4217216,N,NULL,9,15/12/2020,NULL
252534,175647,49,28/12/2024,4269931,380639,327924,52715,3889292,N,NULL,9,15/12/2020,NULL
252535,175647,50,28/01/2025,3937908,380639,332023,48616,3557269,N,NULL,9,15/12/2020,NULL
252536,175647,51,28/02/2025,3601735,380639,336173,44466,3221096,N,NULL,9,15/12/2020,NULL
252537,175647,52,28/03/2025,3261360,380639,340375,40264,2880721,N,NULL,9,15/12/2020,NULL
252538,175647,53,28/04/2025,2916730,380639,344630,36009,2536091,N,NULL,9,15/12/2020,NULL
252539,175647,54,28/05/2025,2567792,380639,348938,31701,2187153,N,NULL,9,15/12/2020,NULL
252540,175647,55,28/06/2025,2214493,380639,353299,27339,1833854,N,NULL,9,15/12/2020,NULL
252541,175647,56,28/07/2025,1856777,380639,357716,22923,1476138,N,NULL,9,15/12/2020,NULL
252542,175647,57,28/08/2025,1494590,380639,362187,18452,1113951,N,NULL,9,15/12/2020,NULL
252543,175647,58,28/09/2025,1127876,380639,366714,13924,747237,N,NULL,9,15/12/2020,NULL
252544,175647,59,28/10/2025,756578,380639,371298,9340,375939,N,NULL,9,15/12/2020,NULL
252545,175647,60,28/11/2025,380638,380639,375939,4699,0,N,NULL,9,15/12/2020,NULL
252546,175648,1,30/12/2020,23591250,648456,357206,291250,22942794,N,NULL,9,15/12/2020,NULL
252547,175648,2,30/01/2021,23229578,648456,361672,286785,22581122,N,NULL,9,15/12/2020,NULL
252548,175648,3,28/02/2021,22863386,648456,366192,282264,22214930,N,NULL,9,15/12/2020,NULL
252549,175648,4,28/03/2021,22492616,648456,370770,277687,21844160,N,NULL,9,15/12/2020,NULL
252550,175648,5,28/04/2021,22117212,648456,375404,273052,21468756,N,NULL,9,15/12/2020,NULL
252551,175648,6,28/05/2021,21737115,648456,380097,268359,21088659,N,NULL,9,15/12/2020,NULL
252552,175648,7,28/06/2021,21352267,648456,384848,263608,20703811,N,NULL,9,15/12/2020,NULL
252553,175648,8,28/07/2021,20962608,648456,389659,258798,20314152,N,NULL,9,15/12/2020,NULL
252554,175648,9,28/08/2021,20568078,648456,394530,253927,19919622,N,NULL,9,15/12/2020,NULL
252555,175648,10,28/09/2021,20168617,648456,399461,248995,19520161,N,NULL,9,15/12/2020,NULL
252556,175648,11,28/10/2021,19764163,648456,404454,244002,19115707,N,NULL,9,15/12/2020,NULL
252557,175648,12,28/11/2021,19354653,648456,409510,238946,18706197,N,NULL,9,15/12/2020,NULL
252558,175648,13,28/12/2021,18940024,648456,414629,233827,18291568,N,NULL,9,15/12/2020,NULL
252559,175648,14,28/01/2022,18520212,648456,419812,228645,17871756,N,NULL,9,15/12/2020,NULL
252560,175648,15,28/02/2022,18095153,648456,425059,223397,17446697,N,NULL,9,15/12/2020,NULL
252561,175648,16,28/03/2022,17664780,648456,430373,218084,17016324,N,NULL,9,15/12/2020,NULL
252562,175648,17,28/04/2022,17229028,648456,435752,212704,16580572,N,NULL,9,15/12/2020,NULL
252563,175648,18,28/05/2022,16787829,648456,441199,207257,16139373,N,NULL,9,15/12/2020,NULL
252564,175648,19,28/06/2022,16341115,648456,446714,201742,15692659,N,NULL,9,15/12/2020,NULL
252565,175648,20,28/07/2022,15888817,648456,452298,196158,15240361,N,NULL,9,15/12/2020,NULL
252566,175648,21,28/08/2022,15430865,648456,457952,190504,14782409,N,NULL,9,15/12/2020,NULL
252567,175648,22,28/09/2022,14967189,648456,463676,184780,14318733,N,NULL,9,15/12/2020,NULL
252568,175648,23,28/10/2022,14497717,648456,469472,178984,13849261,N,NULL,9,15/12/2020,NULL
252569,175648,24,28/11/2022,14022376,648456,475341,173116,13373920,N,NULL,9,15/12/2020,NULL
252570,175648,25,28/12/2022,13541094,648456,481282,167174,12892638,N,NULL,9,15/12/2020,NULL
252571,175648,26,28/01/2023,13053796,648456,487298,161158,12405340,N,NULL,9,15/12/2020,NULL
252572,175648,27,28/02/2023,12560406,648456,493390,155067,11911950,N,NULL,9,15/12/2020,NULL
252573,175648,28,28/03/2023,12060849,648456,499557,148899,11412393,N,NULL,9,15/12/2020,NULL
252574,175648,29,28/04/2023,11555047,648456,505802,142655,10906591,N,NULL,9,15/12/2020,NULL
252575,175648,30,28/05/2023,11042923,648456,512124,136332,10394467,N,NULL,9,15/12/2020,NULL
252576,175648,31,28/06/2023,10524397,648456,518526,129931,9875941,N,NULL,9,15/12/2020,NULL
252577,175648,32,28/07/2023,9999390,648456,525007,123449,9350934,N,NULL,9,15/12/2020,NULL
252578,175648,33,28/08/2023,9467820,648456,531570,116887,8819364,N,NULL,9,15/12/2020,NULL
252579,175648,34,28/09/2023,8929606,648456,538214,110242,8281150,N,NULL,9,15/12/2020,NULL
252580,175648,35,28/10/2023,8384664,648456,544942,103514,7736208,N,NULL,9,15/12/2020,NULL
252581,175648,36,28/11/2023,7832910,648456,551754,96703,7184454,N,NULL,9,15/12/2020,NULL
252582,175648,37,28/12/2023,7274259,648456,558651,89806,6625803,N,NULL,9,15/12/2020,NULL
252583,175648,38,28/01/2024,6708625,648456,565634,82823,6060169,N,NULL,9,15/12/2020,NULL
252584,175648,39,28/02/2024,6135921,648456,572704,75752,5487465,N,NULL,9,15/12/2020,NULL
252585,175648,40,28/03/2024,5556058,648456,579863,68593,4907602,N,NULL,9,15/12/2020,NULL
252586,175648,41,28/04/2024,4968947,648456,587111,61345,4320491,N,NULL,9,15/12/2020,NULL
252587,175648,42,28/05/2024,4374497,648456,594450,54006,3726041,N,NULL,9,15/12/2020,NULL
252588,175648,43,28/06/2024,3772616,648456,601881,46575,3124160,N,NULL,9,15/12/2020,NULL
252589,175648,44,28/07/2024,3163212,648456,609404,39052,2514756,N,NULL,9,15/12/2020,NULL
252590,175648,45,28/08/2024,2546190,648456,617022,31434,1897734,N,NULL,9,15/12/2020,NULL
252591,175648,46,28/09/2024,1921455,648456,624735,23722,1272999,N,NULL,9,15/12/2020,NULL
252592,175648,47,28/10/2024,1288911,648456,632544,15912,640455,N,NULL,9,15/12/2020,NULL
252593,175648,48,28/11/2024,648460,648456,640455,8006,0,N,NULL,9,15/12/2020,NULL
252594,175649,1,30/12/2020,8100000,190319,90319,100000,7909681,N,NULL,9,15/12/2020,NULL
252595,175649,2,30/01/2021,8008552,190319,91448,98871,7818233,N,NULL,9,15/12/2020,NULL
252596,175649,3,28/02/2021,7915960,190319,92592,97728,7725641,N,NULL,9,15/12/2020,NULL
252597,175649,4,28/03/2021,7822211,190319,93749,96571,7631892,N,NULL,9,15/12/2020,NULL
252598,175649,5,28/04/2021,7727290,190319,94921,95399,7536971,N,NULL,9,15/12/2020,NULL
252599,175649,6,28/05/2021,7631183,190319,96107,94212,7440864,N,NULL,9,15/12/2020,NULL
252600,175649,7,28/06/2021,7533874,190319,97309,93011,7343555,N,NULL,9,15/12/2020,NULL
252601,175649,8,28/07/2021,7435349,190319,98525,91794,7245030,N,NULL,9,15/12/2020,NULL
252602,175649,9,28/08/2021,7335592,190319,99757,90563,7145273,N,NULL,9,15/12/2020,NULL
252603,175649,10,28/09/2021,7234588,190319,101004,89316,7044269,N,NULL,9,15/12/2020,NULL
252604,175649,11,28/10/2021,7132322,190319,102266,88053,6942003,N,NULL,9,15/12/2020,NULL
252605,175649,12,28/11/2021,7028778,190319,103544,86775,6838459,N,NULL,9,15/12/2020,NULL
252606,175649,13,28/12/2021,6923939,190319,104839,85481,6733620,N,NULL,9,15/12/2020,NULL
252607,175649,14,28/01/2022,6817790,190319,106149,84170,6627471,N,NULL,9,15/12/2020,NULL
252608,175649,15,28/02/2022,6710314,190319,107476,82843,6519995,N,NULL,9,15/12/2020,NULL
252609,175649,16,28/03/2022,6601495,190319,108819,81500,6411176,N,NULL,9,15/12/2020,NULL
252610,175649,17,28/04/2022,6491315,190319,110180,80140,6300996,N,NULL,9,15/12/2020,NULL
252611,175649,18,28/05/2022,6379758,190319,111557,78762,6189439,N,NULL,9,15/12/2020,NULL
252612,175649,19,28/06/2022,6266807,190319,112951,77368,6076488,N,NULL,9,15/12/2020,NULL
252613,175649,20,28/07/2022,6152444,190319,114363,75956,5962125,N,NULL,9,15/12/2020,NULL
252614,175649,21,28/08/2022,6036651,190319,115793,74527,5846332,N,NULL,9,15/12/2020,NULL
252615,175649,22,28/09/2022,5919411,190319,117240,73079,5729092,N,NULL,9,15/12/2020,NULL
252616,175649,23,28/10/2022,5800705,190319,118706,71614,5610386,N,NULL,9,15/12/2020,NULL
252617,175649,24,28/11/2022,5680515,190319,120190,70130,5490196,N,NULL,9,15/12/2020,NULL
252618,175649,25,28/12/2022,5558823,190319,121692,68627,5368504,N,NULL,9,15/12/2020,NULL
252619,175649,26,28/01/2023,5435610,190319,123213,67106,5245291,N,NULL,9,15/12/2020,NULL
252620,175649,27,28/02/2023,5310857,190319,124753,65566,5120538,N,NULL,9,15/12/2020,NULL
252621,175649,28,28/03/2023,5184544,190319,126313,64007,4994225,N,NULL,9,15/12/2020,NULL
252622,175649,29,28/04/2023,5056652,190319,127892,62428,4866333,N,NULL,9,15/12/2020,NULL
252623,175649,30,28/05/2023,4927162,190319,129490,60829,4736843,N,NULL,9,15/12/2020,NULL
252624,175649,31,28/06/2023,4796053,190319,131109,59211,4605734,N,NULL,9,15/12/2020,NULL
252625,175649,32,28/07/2023,4663305,190319,132748,57572,4472986,N,NULL,9,15/12/2020,NULL
252626,175649,33,28/08/2023,4528898,190319,134407,55912,4338579,N,NULL,9,15/12/2020,NULL
252627,175649,34,28/09/2023,4392811,190319,136087,54232,4202492,N,NULL,9,15/12/2020,NULL
252628,175649,35,28/10/2023,4255023,190319,137788,52531,4064704,N,NULL,9,15/12/2020,NULL
252629,175649,36,28/11/2023,4115512,190319,139511,50809,3925193,N,NULL,9,15/12/2020,NULL
252630,175649,37,28/12/2023,3974257,190319,141255,49065,3783938,N,NULL,9,15/12/2020,NULL
252631,175649,38,28/01/2024,3831237,190319,143020,47299,3640918,N,NULL,9,15/12/2020,NULL
252632,175649,39,28/02/2024,3686429,190319,144808,45511,3496110,N,NULL,9,15/12/2020,NULL
252633,175649,40,28/03/2024,3539811,190319,146618,43701,3349492,N,NULL,9,15/12/2020,NULL
252634,175649,41,28/04/2024,3391360,190319,148451,41869,3201041,N,NULL,9,15/12/2020,NULL
252635,175649,42,28/05/2024,3241054,190319,150306,40013,3050735,N,NULL,9,15/12/2020,NULL
252636,175649,43,28/06/2024,3088869,190319,152185,38134,2898550,N,NULL,9,15/12/2020,NULL
252637,175649,44,28/07/2024,2934781,190319,154088,36232,2744462,N,NULL,9,15/12/2020,NULL
252638,175649,45,28/08/2024,2778767,190319,156014,34306,2588448,N,NULL,9,15/12/2020,NULL
252639,175649,46,28/09/2024,2620803,190319,157964,32356,2430484,N,NULL,9,15/12/2020,NULL
252640,175649,47,28/10/2024,2460865,190319,159938,30381,2270546,N,NULL,9,15/12/2020,NULL
252641,175649,48,28/11/2024,2298927,190319,161938,28382,2108608,N,NULL,9,15/12/2020,NULL
252642,175649,49,28/12/2024,2134965,190319,163962,26358,1944646,N,NULL,9,15/12/2020,NULL
252643,175649,50,28/01/2025,1968954,190319,166011,24308,1778635,N,NULL,9,15/12/2020,NULL
252644,175649,51,28/02/2025,1800868,190319,168086,22233,1610549,N,NULL,9,15/12/2020,NULL
252645,175649,52,28/03/2025,1630680,190319,170188,20132,1440361,N,NULL,9,15/12/2020,NULL
252646,175649,53,28/04/2025,1458365,190319,172315,18005,1268046,N,NULL,9,15/12/2020,NULL
252647,175649,54,28/05/2025,1283896,190319,174469,15851,1093577,N,NULL,9,15/12/2020,NULL
252648,175649,55,28/06/2025,1107246,190319,176650,13670,916927,N,NULL,9,15/12/2020,NULL
252649,175649,56,28/07/2025,928388,190319,178858,11462,738069,N,NULL,9,15/12/2020,NULL
252650,175649,57,28/08/2025,747294,190319,181094,9226,556975,N,NULL,9,15/12/2020,NULL
252651,175649,58,28/09/2025,563937,190319,183357,6962,373618,N,NULL,9,15/12/2020,NULL
252652,175649,59,28/10/2025,378288,190319,185649,4670,187969,N,NULL,9,15/12/2020,NULL
252653,175649,60,28/11/2025,190318,190319,187969,2350,0,N,NULL,9,15/12/2020,NULL
252654,175650,1,30/12/2020,16200000,554645,354645,200000,15645355,N,NULL,9,16/12/2020,NULL
252655,175650,2,30/01/2021,15840922,554645,359078,195567,15286277,N,NULL,9,16/12/2020,NULL
252656,175650,3,28/02/2021,15477355,554645,363567,191078,14922710,N,NULL,9,16/12/2020,NULL
252657,175650,4,28/03/2021,15109244,554645,368111,186534,14554599,N,NULL,9,16/12/2020,NULL
252658,175650,5,28/04/2021,14736531,554645,372713,181932,14181886,N,NULL,9,16/12/2020,NULL
252659,175650,6,28/05/2021,14359159,554645,377372,177274,13804514,N,NULL,9,16/12/2020,NULL
252660,175650,7,28/06/2021,13977070,554645,382089,172556,13422425,N,NULL,9,16/12/2020,NULL
252661,175650,8,28/07/2021,13590205,554645,386865,167780,13035560,N,NULL,9,16/12/2020,NULL
252662,175650,9,28/08/2021,13198504,554645,391701,162944,12643859,N,NULL,9,16/12/2020,NULL
252663,175650,10,28/09/2021,12801907,554645,396597,158048,12247262,N,NULL,9,16/12/2020,NULL
252664,175650,11,28/10/2021,12400353,554645,401554,153091,11845708,N,NULL,9,16/12/2020,NULL
252665,175650,12,28/11/2021,11993779,554645,406574,148071,11439134,N,NULL,9,16/12/2020,NULL
252666,175650,13,28/12/2021,11582123,554645,411656,142989,11027478,N,NULL,9,16/12/2020,NULL
252667,175650,14,28/01/2022,11165321,554645,416802,137843,10610676,N,NULL,9,16/12/2020,NULL
252668,175650,15,28/02/2022,10743309,554645,422012,132633,10188664,N,NULL,9,16/12/2020,NULL
252669,175650,16,28/03/2022,10316022,554645,427287,127358,9761377,N,NULL,9,16/12/2020,NULL
252670,175650,17,28/04/2022,9883394,554645,432628,122017,9328749,N,NULL,9,16/12/2020,NULL
252671,175650,18,28/05/2022,9445358,554645,438036,116609,8890713,N,NULL,9,16/12/2020,NULL
252672,175650,19,28/06/2022,9001847,554645,443511,111134,8447202,N,NULL,9,16/12/2020,NULL
252673,175650,20,28/07/2022,8552792,554645,449055,105590,7998147,N,NULL,9,16/12/2020,NULL
252674,175650,21,28/08/2022,8098124,554645,454668,99977,7543479,N,NULL,9,16/12/2020,NULL
252675,175650,22,28/09/2022,7637772,554645,460352,94293,7083127,N,NULL,9,16/12/2020,NULL
252676,175650,23,28/10/2022,7171666,554645,466106,88539,6617021,N,NULL,9,16/12/2020,NULL
252677,175650,24,28/11/2022,6699733,554645,471933,82713,6145088,N,NULL,9,16/12/2020,NULL
252678,175650,25,28/12/2022,6221901,554645,477832,76814,5667256,N,NULL,9,16/12/2020,NULL
252679,175650,26,28/01/2023,5738096,554645,483805,70841,5183451,N,NULL,9,16/12/2020,NULL
252680,175650,27,28/02/2023,5248244,554645,489852,64793,4693599,N,NULL,9,16/12/2020,NULL
252681,175650,28,28/03/2023,4752269,554645,495975,58670,4197624,N,NULL,9,16/12/2020,NULL
252682,175650,29,28/04/2023,4250094,554645,502175,52470,3695449,N,NULL,9,16/12/2020,NULL
252683,175650,30,28/05/2023,3741642,554645,508452,46193,3186997,N,NULL,9,16/12/2020,NULL
252684,175650,31,28/06/2023,3226834,554645,514808,39837,2672189,N,NULL,9,16/12/2020,NULL
252685,175650,32,28/07/2023,2705591,554645,521243,33402,2150946,N,NULL,9,16/12/2020,NULL
252686,175650,33,28/08/2023,2177833,554645,527758,26887,1623188,N,NULL,9,16/12/2020,NULL
252687,175650,34,28/09/2023,1643478,554645,534355,20290,1088833,N,NULL,9,16/12/2020,NULL
252688,175650,35,28/10/2023,1102443,554645,541035,13610,547798,N,NULL,9,16/12/2020,NULL
252689,175650,36,28/11/2023,554645,554645,547798,6847,0,N,NULL,9,16/12/2020,NULL
252690,175651,1,30/12/2020,8100000,190319,90319,100000,7909681,N,NULL,9,16/12/2020,NULL
252691,175651,2,30/01/2021,8008552,190319,91448,98871,7818233,N,NULL,9,16/12/2020,NULL
252692,175651,3,28/02/2021,7915960,190319,92592,97728,7725641,N,NULL,9,16/12/2020,NULL
252693,175651,4,28/03/2021,7822211,190319,93749,96571,7631892,N,NULL,9,16/12/2020,NULL
252694,175651,5,28/04/2021,7727290,190319,94921,95399,7536971,N,NULL,9,16/12/2020,NULL
252695,175651,6,28/05/2021,7631183,190319,96107,94212,7440864,N,NULL,9,16/12/2020,NULL
252696,175651,7,28/06/2021,7533874,190319,97309,93011,7343555,N,NULL,9,16/12/2020,NULL
252697,175651,8,28/07/2021,7435349,190319,98525,91794,7245030,N,NULL,9,16/12/2020,NULL
252698,175651,9,28/08/2021,7335592,190319,99757,90563,7145273,N,NULL,9,16/12/2020,NULL
252699,175651,10,28/09/2021,7234588,190319,101004,89316,7044269,N,NULL,9,16/12/2020,NULL
252700,175651,11,28/10/2021,7132322,190319,102266,88053,6942003,N,NULL,9,16/12/2020,NULL
252701,175651,12,28/11/2021,7028778,190319,103544,86775,6838459,N,NULL,9,16/12/2020,NULL
252702,175651,13,28/12/2021,6923939,190319,104839,85481,6733620,N,NULL,9,16/12/2020,NULL
252703,175651,14,28/01/2022,6817790,190319,106149,84170,6627471,N,NULL,9,16/12/2020,NULL
252704,175651,15,28/02/2022,6710314,190319,107476,82843,6519995,N,NULL,9,16/12/2020,NULL
252705,175651,16,28/03/2022,6601495,190319,108819,81500,6411176,N,NULL,9,16/12/2020,NULL
252706,175651,17,28/04/2022,6491315,190319,110180,80140,6300996,N,NULL,9,16/12/2020,NULL
252707,175651,18,28/05/2022,6379758,190319,111557,78762,6189439,N,NULL,9,16/12/2020,NULL
252708,175651,19,28/06/2022,6266807,190319,112951,77368,6076488,N,NULL,9,16/12/2020,NULL
252709,175651,20,28/07/2022,6152444,190319,114363,75956,5962125,N,NULL,9,16/12/2020,NULL
252710,175651,21,28/08/2022,6036651,190319,115793,74527,5846332,N,NULL,9,16/12/2020,NULL
252711,175651,22,28/09/2022,5919411,190319,117240,73079,5729092,N,NULL,9,16/12/2020,NULL
252712,175651,23,28/10/2022,5800705,190319,118706,71614,5610386,N,NULL,9,16/12/2020,NULL
252713,175651,24,28/11/2022,5680515,190319,120190,70130,5490196,N,NULL,9,16/12/2020,NULL
252714,175651,25,28/12/2022,5558823,190319,121692,68627,5368504,N,NULL,9,16/12/2020,NULL
252715,175651,26,28/01/2023,5435610,190319,123213,67106,5245291,N,NULL,9,16/12/2020,NULL
252716,175651,27,28/02/2023,5310857,190319,124753,65566,5120538,N,NULL,9,16/12/2020,NULL
252717,175651,28,28/03/2023,5184544,190319,126313,64007,4994225,N,NULL,9,16/12/2020,NULL
252718,175651,29,28/04/2023,5056652,190319,127892,62428,4866333,N,NULL,9,16/12/2020,NULL
252719,175651,30,28/05/2023,4927162,190319,129490,60829,4736843,N,NULL,9,16/12/2020,NULL
252720,175651,31,28/06/2023,4796053,190319,131109,59211,4605734,N,NULL,9,16/12/2020,NULL
252721,175651,32,28/07/2023,4663305,190319,132748,57572,4472986,N,NULL,9,16/12/2020,NULL
252722,175651,33,28/08/2023,4528898,190319,134407,55912,4338579,N,NULL,9,16/12/2020,NULL
252723,175651,34,28/09/2023,4392811,190319,136087,54232,4202492,N,NULL,9,16/12/2020,NULL
252724,175651,35,28/10/2023,4255023,190319,137788,52531,4064704,N,NULL,9,16/12/2020,NULL
252725,175651,36,28/11/2023,4115512,190319,139511,50809,3925193,N,NULL,9,16/12/2020,NULL
252726,175651,37,28/12/2023,3974257,190319,141255,49065,3783938,N,NULL,9,16/12/2020,NULL
252727,175651,38,28/01/2024,3831237,190319,143020,47299,3640918,N,NULL,9,16/12/2020,NULL
252728,175651,39,28/02/2024,3686429,190319,144808,45511,3496110,N,NULL,9,16/12/2020,NULL
252729,175651,40,28/03/2024,3539811,190319,146618,43701,3349492,N,NULL,9,16/12/2020,NULL
252730,175651,41,28/04/2024,3391360,190319,148451,41869,3201041,N,NULL,9,16/12/2020,NULL
252731,175651,42,28/05/2024,3241054,190319,150306,40013,3050735,N,NULL,9,16/12/2020,NULL
252732,175651,43,28/06/2024,3088869,190319,152185,38134,2898550,N,NULL,9,16/12/2020,NULL
252733,175651,44,28/07/2024,2934781,190319,154088,36232,2744462,N,NULL,9,16/12/2020,NULL
252734,175651,45,28/08/2024,2778767,190319,156014,34306,2588448,N,NULL,9,16/12/2020,NULL
252735,175651,46,28/09/2024,2620803,190319,157964,32356,2430484,N,NULL,9,16/12/2020,NULL
252736,175651,47,28/10/2024,2460865,190319,159938,30381,2270546,N,NULL,9,16/12/2020,NULL
252737,175651,48,28/11/2024,2298927,190319,161938,28382,2108608,N,NULL,9,16/12/2020,NULL
252738,175651,49,28/12/2024,2134965,190319,163962,26358,1944646,N,NULL,9,16/12/2020,NULL
252739,175651,50,28/01/2025,1968954,190319,166011,24308,1778635,N,NULL,9,16/12/2020,NULL
252740,175651,51,28/02/2025,1800868,190319,168086,22233,1610549,N,NULL,9,16/12/2020,NULL
252741,175651,52,28/03/2025,1630680,190319,170188,20132,1440361,N,NULL,9,16/12/2020,NULL
252742,175651,53,28/04/2025,1458365,190319,172315,18005,1268046,N,NULL,9,16/12/2020,NULL
252743,175651,54,28/05/2025,1283896,190319,174469,15851,1093577,N,NULL,9,16/12/2020,NULL
252744,175651,55,28/06/2025,1107246,190319,176650,13670,916927,N,NULL,9,16/12/2020,NULL
252745,175651,56,28/07/2025,928388,190319,178858,11462,738069,N,NULL,9,16/12/2020,NULL
252746,175651,57,28/08/2025,747294,190319,181094,9226,556975,N,NULL,9,16/12/2020,NULL
252747,175651,58,28/09/2025,563937,190319,183357,6962,373618,N,NULL,9,16/12/2020,NULL
252748,175651,59,28/10/2025,378288,190319,185649,4670,187969,N,NULL,9,16/12/2020,NULL
252749,175651,60,28/11/2025,190318,190319,187969,2350,0,N,NULL,9,16/12/2020,NULL
252750,175652,1,30/12/2020,8100000,190319,90319,100000,7909681,N,NULL,9,16/12/2020,NULL
252751,175652,2,30/01/2021,8008552,190319,91448,98871,7818233,N,NULL,9,16/12/2020,NULL
252752,175652,3,28/02/2021,7915960,190319,92592,97728,7725641,N,NULL,9,16/12/2020,NULL
252753,175652,4,28/03/2021,7822211,190319,93749,96571,7631892,N,NULL,9,16/12/2020,NULL
252754,175652,5,28/04/2021,7727290,190319,94921,95399,7536971,N,NULL,9,16/12/2020,NULL
252755,175652,6,28/05/2021,7631183,190319,96107,94212,7440864,N,NULL,9,16/12/2020,NULL
252756,175652,7,28/06/2021,7533874,190319,97309,93011,7343555,N,NULL,9,16/12/2020,NULL
252757,175652,8,28/07/2021,7435349,190319,98525,91794,7245030,N,NULL,9,16/12/2020,NULL
252758,175652,9,28/08/2021,7335592,190319,99757,90563,7145273,N,NULL,9,16/12/2020,NULL
252759,175652,10,28/09/2021,7234588,190319,101004,89316,7044269,N,NULL,9,16/12/2020,NULL
252760,175652,11,28/10/2021,7132322,190319,102266,88053,6942003,N,NULL,9,16/12/2020,NULL
252761,175652,12,28/11/2021,7028778,190319,103544,86775,6838459,N,NULL,9,16/12/2020,NULL
252762,175652,13,28/12/2021,6923939,190319,104839,85481,6733620,N,NULL,9,16/12/2020,NULL
252763,175652,14,28/01/2022,6817790,190319,106149,84170,6627471,N,NULL,9,16/12/2020,NULL
252764,175652,15,28/02/2022,6710314,190319,107476,82843,6519995,N,NULL,9,16/12/2020,NULL
252765,175652,16,28/03/2022,6601495,190319,108819,81500,6411176,N,NULL,9,16/12/2020,NULL
252766,175652,17,28/04/2022,6491315,190319,110180,80140,6300996,N,NULL,9,16/12/2020,NULL
252767,175652,18,28/05/2022,6379758,190319,111557,78762,6189439,N,NULL,9,16/12/2020,NULL
252768,175652,19,28/06/2022,6266807,190319,112951,77368,6076488,N,NULL,9,16/12/2020,NULL
252769,175652,20,28/07/2022,6152444,190319,114363,75956,5962125,N,NULL,9,16/12/2020,NULL
252770,175652,21,28/08/2022,6036651,190319,115793,74527,5846332,N,NULL,9,16/12/2020,NULL
252771,175652,22,28/09/2022,5919411,190319,117240,73079,5729092,N,NULL,9,16/12/2020,NULL
252772,175652,23,28/10/2022,5800705,190319,118706,71614,5610386,N,NULL,9,16/12/2020,NULL
252773,175652,24,28/11/2022,5680515,190319,120190,70130,5490196,N,NULL,9,16/12/2020,NULL
252774,175652,25,28/12/2022,5558823,190319,121692,68627,5368504,N,NULL,9,16/12/2020,NULL
252775,175652,26,28/01/2023,5435610,190319,123213,67106,5245291,N,NULL,9,16/12/2020,NULL
252776,175652,27,28/02/2023,5310857,190319,124753,65566,5120538,N,NULL,9,16/12/2020,NULL
252777,175652,28,28/03/2023,5184544,190319,126313,64007,4994225,N,NULL,9,16/12/2020,NULL
252778,175652,29,28/04/2023,5056652,190319,127892,62428,4866333,N,NULL,9,16/12/2020,NULL
252779,175652,30,28/05/2023,4927162,190319,129490,60829,4736843,N,NULL,9,16/12/2020,NULL
252780,175652,31,28/06/2023,4796053,190319,131109,59211,4605734,N,NULL,9,16/12/2020,NULL
252781,175652,32,28/07/2023,4663305,190319,132748,57572,4472986,N,NULL,9,16/12/2020,NULL
252782,175652,33,28/08/2023,4528898,190319,134407,55912,4338579,N,NULL,9,16/12/2020,NULL
252783,175652,34,28/09/2023,4392811,190319,136087,54232,4202492,N,NULL,9,16/12/2020,NULL
252784,175652,35,28/10/2023,4255023,190319,137788,52531,4064704,N,NULL,9,16/12/2020,NULL
252785,175652,36,28/11/2023,4115512,190319,139511,50809,3925193,N,NULL,9,16/12/2020,NULL
252786,175652,37,28/12/2023,3974257,190319,141255,49065,3783938,N,NULL,9,16/12/2020,NULL
252787,175652,38,28/01/2024,3831237,190319,143020,47299,3640918,N,NULL,9,16/12/2020,NULL
252788,175652,39,28/02/2024,3686429,190319,144808,45511,3496110,N,NULL,9,16/12/2020,NULL
252789,175652,40,28/03/2024,3539811,190319,146618,43701,3349492,N,NULL,9,16/12/2020,NULL
252790,175652,41,28/04/2024,3391360,190319,148451,41869,3201041,N,NULL,9,16/12/2020,NULL
252791,175652,42,28/05/2024,3241054,190319,150306,40013,3050735,N,NULL,9,16/12/2020,NULL
252792,175652,43,28/06/2024,3088869,190319,152185,38134,2898550,N,NULL,9,16/12/2020,NULL
252793,175652,44,28/07/2024,2934781,190319,154088,36232,2744462,N,NULL,9,16/12/2020,NULL
252794,175652,45,28/08/2024,2778767,190319,156014,34306,2588448,N,NULL,9,16/12/2020,NULL
252795,175652,46,28/09/2024,2620803,190319,157964,32356,2430484,N,NULL,9,16/12/2020,NULL
252796,175652,47,28/10/2024,2460865,190319,159938,30381,2270546,N,NULL,9,16/12/2020,NULL
252797,175652,48,28/11/2024,2298927,190319,161938,28382,2108608,N,NULL,9,16/12/2020,NULL
252798,175652,49,28/12/2024,2134965,190319,163962,26358,1944646,N,NULL,9,16/12/2020,NULL
252799,175652,50,28/01/2025,1968954,190319,166011,24308,1778635,N,NULL,9,16/12/2020,NULL
252800,175652,51,28/02/2025,1800868,190319,168086,22233,1610549,N,NULL,9,16/12/2020,NULL
252801,175652,52,28/03/2025,1630680,190319,170188,20132,1440361,N,NULL,9,16/12/2020,NULL
252802,175652,53,28/04/2025,1458365,190319,172315,18005,1268046,N,NULL,9,16/12/2020,NULL
252803,175652,54,28/05/2025,1283896,190319,174469,15851,1093577,N,NULL,9,16/12/2020,NULL
252804,175652,55,28/06/2025,1107246,190319,176650,13670,916927,N,NULL,9,16/12/2020,NULL
252805,175652,56,28/07/2025,928388,190319,178858,11462,738069,N,NULL,9,16/12/2020,NULL
252806,175652,57,28/08/2025,747294,190319,181094,9226,556975,N,NULL,9,16/12/2020,NULL
252807,175652,58,28/09/2025,563937,190319,183357,6962,373618,N,NULL,9,16/12/2020,NULL
252808,175652,59,28/10/2025,378288,190319,185649,4670,187969,N,NULL,9,16/12/2020,NULL
252809,175652,60,28/11/2025,190318,190319,187969,2350,0,N,NULL,9,16/12/2020,NULL
252810,175653,1,30/12/2020,16200000,775786,575786,200000,15424214,N,NULL,9,16/12/2020,NULL
252811,175653,2,30/01/2021,15617016,775786,582984,192803,14841230,N,NULL,9,16/12/2020,NULL
252812,175653,3,28/02/2021,15026745,775786,590271,185515,14250959,N,NULL,9,16/12/2020,NULL
252813,175653,4,28/03/2021,14429096,775786,597649,178137,13653310,N,NULL,9,16/12/2020,NULL
252814,175653,5,28/04/2021,13823976,775786,605120,170666,13048190,N,NULL,9,16/12/2020,NULL
252815,175653,6,28/05/2021,13211292,775786,612684,163102,12435506,N,NULL,9,16/12/2020,NULL
252816,175653,7,28/06/2021,12590949,775786,620343,155444,11815163,N,NULL,9,16/12/2020,NULL
252817,175653,8,28/07/2021,11962852,775786,628097,147690,11187066,N,NULL,9,16/12/2020,NULL
252818,175653,9,28/08/2021,11326904,775786,635948,139838,10551118,N,NULL,9,16/12/2020,NULL
252819,175653,10,28/09/2021,10683007,775786,643897,131889,9907221,N,NULL,9,16/12/2020,NULL
252820,175653,11,28/10/2021,10031061,775786,651946,123840,9255275,N,NULL,9,16/12/2020,NULL
252821,175653,12,28/11/2021,9370966,775786,660095,115691,8595180,N,NULL,9,16/12/2020,NULL
252822,175653,13,28/12/2021,8702619,775786,668347,107440,7926833,N,NULL,9,16/12/2020,NULL
252823,175653,14,28/01/2022,8025918,775786,676701,99085,7250132,N,NULL,9,16/12/2020,NULL
252824,175653,15,28/02/2022,7340758,775786,685160,90627,6564972,N,NULL,9,16/12/2020,NULL
252825,175653,16,28/03/2022,6647034,775786,693724,82062,5871248,N,NULL,9,16/12/2020,NULL
252826,175653,17,28/04/2022,5944638,775786,702396,73391,5168852,N,NULL,9,16/12/2020,NULL
252827,175653,18,28/05/2022,5233462,775786,711176,64611,4457676,N,NULL,9,16/12/2020,NULL
252828,175653,19,28/06/2022,4513397,775786,720065,55721,3737611,N,NULL,9,16/12/2020,NULL
252829,175653,20,28/07/2022,3784331,775786,729066,46720,3008545,N,NULL,9,16/12/2020,NULL
252830,175653,21,28/08/2022,3046151,775786,738180,37607,2270365,N,NULL,9,16/12/2020,NULL
252831,175653,22,28/09/2022,2298744,775786,747407,28380,1522958,N,NULL,9,16/12/2020,NULL
252832,175653,23,28/10/2022,1541995,775786,756749,19037,766209,N,NULL,9,16/12/2020,NULL
252833,175653,24,28/11/2022,775786,775786,766209,9578,0,N,NULL,9,16/12/2020,NULL
252834,175654,1,30/12/2020,16200000,380639,180639,200000,15819361,N,NULL,9,16/12/2020,NULL
252835,175654,2,30/01/2021,16017103,380639,182897,197742,15636464,N,NULL,9,16/12/2020,NULL
252836,175654,3,28/02/2021,15831920,380639,185183,195456,15451281,N,NULL,9,16/12/2020,NULL
252837,175654,4,28/03/2021,15644422,380639,187498,193141,15263783,N,NULL,9,16/12/2020,NULL
252838,175654,5,28/04/2021,15454580,380639,189842,190797,15073941,N,NULL,9,16/12/2020,NULL
252839,175654,6,28/05/2021,15262365,380639,192215,188424,14881726,N,NULL,9,16/12/2020,NULL
252840,175654,7,28/06/2021,15067748,380639,194617,186022,14687109,N,NULL,9,16/12/2020,NULL
252841,175654,8,28/07/2021,14870698,380639,197050,183589,14490059,N,NULL,9,16/12/2020,NULL
252842,175654,9,28/08/2021,14671185,380639,199513,181126,14290546,N,NULL,9,16/12/2020,NULL
252843,175654,10,28/09/2021,14469178,380639,202007,178632,14088539,N,NULL,9,16/12/2020,NULL
252844,175654,11,28/10/2021,14264646,380639,204532,176107,13884007,N,NULL,9,16/12/2020,NULL
252845,175654,12,28/11/2021,14057557,380639,207089,173550,13676918,N,NULL,9,16/12/2020,NULL
252846,175654,13,28/12/2021,13847880,380639,209677,170961,13467241,N,NULL,9,16/12/2020,NULL
252847,175654,14,28/01/2022,13635582,380639,212298,168341,13254943,N,NULL,9,16/12/2020,NULL
252848,175654,15,28/02/2022,13420630,380639,214952,165687,13039991,N,NULL,9,16/12/2020,NULL
252849,175654,16,28/03/2022,13202991,380639,217639,163000,12822352,N,NULL,9,16/12/2020,NULL
252850,175654,17,28/04/2022,12982632,380639,220359,160279,12601993,N,NULL,9,16/12/2020,NULL
252851,175654,18,28/05/2022,12759518,380639,223114,157525,12378879,N,NULL,9,16/12/2020,NULL
252852,175654,19,28/06/2022,12533615,380639,225903,154736,12152976,N,NULL,9,16/12/2020,NULL
252853,175654,20,28/07/2022,12304888,380639,228727,151912,11924249,N,NULL,9,16/12/2020,NULL
252854,175654,21,28/08/2022,12073302,380639,231586,149053,11692663,N,NULL,9,16/12/2020,NULL
252855,175654,22,28/09/2022,11838821,380639,234481,146158,11458182,N,NULL,9,16/12/2020,NULL
252856,175654,23,28/10/2022,11601409,380639,237412,143227,11220770,N,NULL,9,16/12/2020,NULL
252857,175654,24,28/11/2022,11361030,380639,240379,140260,10980391,N,NULL,9,16/12/2020,NULL
252858,175654,25,28/12/2022,11117646,380639,243384,137255,10737007,N,NULL,9,16/12/2020,NULL
252859,175654,26,28/01/2023,10871220,380639,246426,134213,10490581,N,NULL,9,16/12/2020,NULL
252860,175654,27,28/02/2023,10621713,380639,249507,131132,10241074,N,NULL,9,16/12/2020,NULL
252861,175654,28,28/03/2023,10369088,380639,252625,128013,9988449,N,NULL,9,16/12/2020,NULL
252862,175654,29,28/04/2023,10113305,380639,255783,124856,9732666,N,NULL,9,16/12/2020,NULL
252863,175654,30,28/05/2023,9854324,380639,258981,121658,9473685,N,NULL,9,16/12/2020,NULL
252864,175654,31,28/06/2023,9592106,380639,262218,118421,9211467,N,NULL,9,16/12/2020,NULL
252865,175654,32,28/07/2023,9326610,380639,265496,115143,8945971,N,NULL,9,16/12/2020,NULL
252866,175654,33,28/08/2023,9057796,380639,268814,111825,8677157,N,NULL,9,16/12/2020,NULL
252867,175654,34,28/09/2023,8785622,380639,272174,108464,8404983,N,NULL,9,16/12/2020,NULL
252868,175654,35,28/10/2023,8510045,380639,275577,105062,8129406,N,NULL,9,16/12/2020,NULL
252869,175654,36,28/11/2023,8231024,380639,279021,101618,7850385,N,NULL,9,16/12/2020,NULL
252870,175654,37,28/12/2023,7948515,380639,282509,98130,7567876,N,NULL,9,16/12/2020,NULL
252871,175654,38,28/01/2024,7662475,380639,286040,94598,7281836,N,NULL,9,16/12/2020,NULL
252872,175654,39,28/02/2024,7372859,380639,289616,91023,6992220,N,NULL,9,16/12/2020,NULL
252873,175654,40,28/03/2024,7079623,380639,293236,87403,6698984,N,NULL,9,16/12/2020,NULL
252874,175654,41,28/04/2024,6782721,380639,296902,83737,6402082,N,NULL,9,16/12/2020,NULL
252875,175654,42,28/05/2024,6482108,380639,300613,80026,6101469,N,NULL,9,16/12/2020,NULL
252876,175654,43,28/06/2024,6177737,380639,304371,76268,5797098,N,NULL,9,16/12/2020,NULL
252877,175654,44,28/07/2024,5869562,380639,308175,72464,5488923,N,NULL,9,16/12/2020,NULL
252878,175654,45,28/08/2024,5557535,380639,312027,68612,5176896,N,NULL,9,16/12/2020,NULL
252879,175654,46,28/09/2024,5241607,380639,315928,64711,4860968,N,NULL,9,16/12/2020,NULL
252880,175654,47,28/10/2024,4921730,380639,319877,60762,4541091,N,NULL,9,16/12/2020,NULL
252881,175654,48,28/11/2024,4597855,380639,323875,56764,4217216,N,NULL,9,16/12/2020,NULL
252882,175654,49,28/12/2024,4269931,380639,327924,52715,3889292,N,NULL,9,16/12/2020,NULL
252883,175654,50,28/01/2025,3937908,380639,332023,48616,3557269,N,NULL,9,16/12/2020,NULL
252884,175654,51,28/02/2025,3601735,380639,336173,44466,3221096,N,NULL,9,16/12/2020,NULL
252885,175654,52,28/03/2025,3261360,380639,340375,40264,2880721,N,NULL,9,16/12/2020,NULL
252886,175654,53,28/04/2025,2916730,380639,344630,36009,2536091,N,NULL,9,16/12/2020,NULL
252887,175654,54,28/05/2025,2567792,380639,348938,31701,2187153,N,NULL,9,16/12/2020,NULL
252888,175654,55,28/06/2025,2214493,380639,353299,27339,1833854,N,NULL,9,16/12/2020,NULL
252889,175654,56,28/07/2025,1856777,380639,357716,22923,1476138,N,NULL,9,16/12/2020,NULL
252890,175654,57,28/08/2025,1494590,380639,362187,18452,1113951,N,NULL,9,16/12/2020,NULL
252891,175654,58,28/09/2025,1127876,380639,366714,13924,747237,N,NULL,9,16/12/2020,NULL
252892,175654,59,28/10/2025,756578,380639,371298,9340,375939,N,NULL,9,16/12/2020,NULL
252893,175654,60,28/11/2025,380638,380639,375939,4699,0,N,NULL,9,16/12/2020,NULL
252894,175655,1,30/12/2020,16200000,775786,575786,200000,15424214,N,NULL,9,16/12/2020,NULL
252895,175655,2,30/01/2021,15617016,775786,582984,192803,14841230,N,NULL,9,16/12/2020,NULL
252896,175655,3,28/02/2021,15026745,775786,590271,185515,14250959,N,NULL,9,16/12/2020,NULL
252897,175655,4,28/03/2021,14429096,775786,597649,178137,13653310,N,NULL,9,16/12/2020,NULL
252898,175655,5,28/04/2021,13823976,775786,605120,170666,13048190,N,NULL,9,16/12/2020,NULL
252899,175655,6,28/05/2021,13211292,775786,612684,163102,12435506,N,NULL,9,16/12/2020,NULL
252900,175655,7,28/06/2021,12590949,775786,620343,155444,11815163,N,NULL,9,16/12/2020,NULL
252901,175655,8,28/07/2021,11962852,775786,628097,147690,11187066,N,NULL,9,16/12/2020,NULL
252902,175655,9,28/08/2021,11326904,775786,635948,139838,10551118,N,NULL,9,16/12/2020,NULL
252903,175655,10,28/09/2021,10683007,775786,643897,131889,9907221,N,NULL,9,16/12/2020,NULL
252904,175655,11,28/10/2021,10031061,775786,651946,123840,9255275,N,NULL,9,16/12/2020,NULL
252905,175655,12,28/11/2021,9370966,775786,660095,115691,8595180,N,NULL,9,16/12/2020,NULL
252906,175655,13,28/12/2021,8702619,775786,668347,107440,7926833,N,NULL,9,16/12/2020,NULL
252907,175655,14,28/01/2022,8025918,775786,676701,99085,7250132,N,NULL,9,16/12/2020,NULL
252908,175655,15,28/02/2022,7340758,775786,685160,90627,6564972,N,NULL,9,16/12/2020,NULL
252909,175655,16,28/03/2022,6647034,775786,693724,82062,5871248,N,NULL,9,16/12/2020,NULL
252910,175655,17,28/04/2022,5944638,775786,702396,73391,5168852,N,NULL,9,16/12/2020,NULL
252911,175655,18,28/05/2022,5233462,775786,711176,64611,4457676,N,NULL,9,16/12/2020,NULL
252912,175655,19,28/06/2022,4513397,775786,720065,55721,3737611,N,NULL,9,16/12/2020,NULL
252913,175655,20,28/07/2022,3784331,775786,729066,46720,3008545,N,NULL,9,16/12/2020,NULL
252914,175655,21,28/08/2022,3046151,775786,738180,37607,2270365,N,NULL,9,16/12/2020,NULL
252915,175655,22,28/09/2022,2298744,775786,747407,28380,1522958,N,NULL,9,16/12/2020,NULL
252916,175655,23,28/10/2022,1541995,775786,756749,19037,766209,N,NULL,9,16/12/2020,NULL
252917,175655,24,28/11/2022,775786,775786,766209,9578,0,N,NULL,9,16/12/2020,NULL
252918,175656,1,30/12/2020,16200000,775786,575786,200000,15424214,N,NULL,9,16/12/2020,NULL
252919,175656,2,30/01/2021,15617016,775786,582984,192803,14841230,N,NULL,9,16/12/2020,NULL
252920,175656,3,28/02/2021,15026745,775786,590271,185515,14250959,N,NULL,9,16/12/2020,NULL
252921,175656,4,28/03/2021,14429096,775786,597649,178137,13653310,N,NULL,9,16/12/2020,NULL
252922,175656,5,28/04/2021,13823976,775786,605120,170666,13048190,N,NULL,9,16/12/2020,NULL
252923,175656,6,28/05/2021,13211292,775786,612684,163102,12435506,N,NULL,9,16/12/2020,NULL
252924,175656,7,28/06/2021,12590949,775786,620343,155444,11815163,N,NULL,9,16/12/2020,NULL
252925,175656,8,28/07/2021,11962852,775786,628097,147690,11187066,N,NULL,9,16/12/2020,NULL
252926,175656,9,28/08/2021,11326904,775786,635948,139838,10551118,N,NULL,9,16/12/2020,NULL
252927,175656,10,28/09/2021,10683007,775786,643897,131889,9907221,N,NULL,9,16/12/2020,NULL
252928,175656,11,28/10/2021,10031061,775786,651946,123840,9255275,N,NULL,9,16/12/2020,NULL
252929,175656,12,28/11/2021,9370966,775786,660095,115691,8595180,N,NULL,9,16/12/2020,NULL
252930,175656,13,28/12/2021,8702619,775786,668347,107440,7926833,N,NULL,9,16/12/2020,NULL
252931,175656,14,28/01/2022,8025918,775786,676701,99085,7250132,N,NULL,9,16/12/2020,NULL
252932,175656,15,28/02/2022,7340758,775786,685160,90627,6564972,N,NULL,9,16/12/2020,NULL
252933,175656,16,28/03/2022,6647034,775786,693724,82062,5871248,N,NULL,9,16/12/2020,NULL
252934,175656,17,28/04/2022,5944638,775786,702396,73391,5168852,N,NULL,9,16/12/2020,NULL
252935,175656,18,28/05/2022,5233462,775786,711176,64611,4457676,N,NULL,9,16/12/2020,NULL
252936,175656,19,28/06/2022,4513397,775786,720065,55721,3737611,N,NULL,9,16/12/2020,NULL
252937,175656,20,28/07/2022,3784331,775786,729066,46720,3008545,N,NULL,9,16/12/2020,NULL
252938,175656,21,28/08/2022,3046151,775786,738180,37607,2270365,N,NULL,9,16/12/2020,NULL
252939,175656,22,28/09/2022,2298744,775786,747407,28380,1522958,N,NULL,9,16/12/2020,NULL
252940,175656,23,28/10/2022,1541995,775786,756749,19037,766209,N,NULL,9,16/12/2020,NULL
252941,175656,24,28/11/2022,775786,775786,766209,9578,0,N,NULL,9,16/12/2020,NULL
252942,175657,1,30/12/2020,8100000,190319,90319,100000,7909681,N,NULL,9,16/12/2020,NULL
252943,175657,2,30/01/2021,8008552,190319,91448,98871,7818233,N,NULL,9,16/12/2020,NULL
252944,175657,3,28/02/2021,7915960,190319,92592,97728,7725641,N,NULL,9,16/12/2020,NULL
252945,175657,4,28/03/2021,7822211,190319,93749,96571,7631892,N,NULL,9,16/12/2020,NULL
252946,175657,5,28/04/2021,7727290,190319,94921,95399,7536971,N,NULL,9,16/12/2020,NULL
252947,175657,6,28/05/2021,7631183,190319,96107,94212,7440864,N,NULL,9,16/12/2020,NULL
252948,175657,7,28/06/2021,7533874,190319,97309,93011,7343555,N,NULL,9,16/12/2020,NULL
252949,175657,8,28/07/2021,7435349,190319,98525,91794,7245030,N,NULL,9,16/12/2020,NULL
252950,175657,9,28/08/2021,7335592,190319,99757,90563,7145273,N,NULL,9,16/12/2020,NULL
252951,175657,10,28/09/2021,7234588,190319,101004,89316,7044269,N,NULL,9,16/12/2020,NULL
252952,175657,11,28/10/2021,7132322,190319,102266,88053,6942003,N,NULL,9,16/12/2020,NULL
252953,175657,12,28/11/2021,7028778,190319,103544,86775,6838459,N,NULL,9,16/12/2020,NULL
252954,175657,13,28/12/2021,6923939,190319,104839,85481,6733620,N,NULL,9,16/12/2020,NULL
252955,175657,14,28/01/2022,6817790,190319,106149,84170,6627471,N,NULL,9,16/12/2020,NULL
252956,175657,15,28/02/2022,6710314,190319,107476,82843,6519995,N,NULL,9,16/12/2020,NULL
252957,175657,16,28/03/2022,6601495,190319,108819,81500,6411176,N,NULL,9,16/12/2020,NULL
252958,175657,17,28/04/2022,6491315,190319,110180,80140,6300996,N,NULL,9,16/12/2020,NULL
252959,175657,18,28/05/2022,6379758,190319,111557,78762,6189439,N,NULL,9,16/12/2020,NULL
252960,175657,19,28/06/2022,6266807,190319,112951,77368,6076488,N,NULL,9,16/12/2020,NULL
252961,175657,20,28/07/2022,6152444,190319,114363,75956,5962125,N,NULL,9,16/12/2020,NULL
252962,175657,21,28/08/2022,6036651,190319,115793,74527,5846332,N,NULL,9,16/12/2020,NULL
252963,175657,22,28/09/2022,5919411,190319,117240,73079,5729092,N,NULL,9,16/12/2020,NULL
252964,175657,23,28/10/2022,5800705,190319,118706,71614,5610386,N,NULL,9,16/12/2020,NULL
252965,175657,24,28/11/2022,5680515,190319,120190,70130,5490196,N,NULL,9,16/12/2020,NULL
252966,175657,25,28/12/2022,5558823,190319,121692,68627,5368504,N,NULL,9,16/12/2020,NULL
252967,175657,26,28/01/2023,5435610,190319,123213,67106,5245291,N,NULL,9,16/12/2020,NULL
252968,175657,27,28/02/2023,5310857,190319,124753,65566,5120538,N,NULL,9,16/12/2020,NULL
252969,175657,28,28/03/2023,5184544,190319,126313,64007,4994225,N,NULL,9,16/12/2020,NULL
252970,175657,29,28/04/2023,5056652,190319,127892,62428,4866333,N,NULL,9,16/12/2020,NULL
252971,175657,30,28/05/2023,4927162,190319,129490,60829,4736843,N,NULL,9,16/12/2020,NULL
252972,175657,31,28/06/2023,4796053,190319,131109,59211,4605734,N,NULL,9,16/12/2020,NULL
252973,175657,32,28/07/2023,4663305,190319,132748,57572,4472986,N,NULL,9,16/12/2020,NULL
252974,175657,33,28/08/2023,4528898,190319,134407,55912,4338579,N,NULL,9,16/12/2020,NULL
252975,175657,34,28/09/2023,4392811,190319,136087,54232,4202492,N,NULL,9,16/12/2020,NULL
252976,175657,35,28/10/2023,4255023,190319,137788,52531,4064704,N,NULL,9,16/12/2020,NULL
252977,175657,36,28/11/2023,4115512,190319,139511,50809,3925193,N,NULL,9,16/12/2020,NULL
252978,175657,37,28/12/2023,3974257,190319,141255,49065,3783938,N,NULL,9,16/12/2020,NULL
252979,175657,38,28/01/2024,3831237,190319,143020,47299,3640918,N,NULL,9,16/12/2020,NULL
252980,175657,39,28/02/2024,3686429,190319,144808,45511,3496110,N,NULL,9,16/12/2020,NULL
252981,175657,40,28/03/2024,3539811,190319,146618,43701,3349492,N,NULL,9,16/12/2020,NULL
252982,175657,41,28/04/2024,3391360,190319,148451,41869,3201041,N,NULL,9,16/12/2020,NULL
252983,175657,42,28/05/2024,3241054,190319,150306,40013,3050735,N,NULL,9,16/12/2020,NULL
252984,175657,43,28/06/2024,3088869,190319,152185,38134,2898550,N,NULL,9,16/12/2020,NULL
252985,175657,44,28/07/2024,2934781,190319,154088,36232,2744462,N,NULL,9,16/12/2020,NULL
252986,175657,45,28/08/2024,2778767,190319,156014,34306,2588448,N,NULL,9,16/12/2020,NULL
252987,175657,46,28/09/2024,2620803,190319,157964,32356,2430484,N,NULL,9,16/12/2020,NULL
252988,175657,47,28/10/2024,2460865,190319,159938,30381,2270546,N,NULL,9,16/12/2020,NULL
252989,175657,48,28/11/2024,2298927,190319,161938,28382,2108608,N,NULL,9,16/12/2020,NULL
252990,175657,49,28/12/2024,2134965,190319,163962,26358,1944646,N,NULL,9,16/12/2020,NULL
252991,175657,50,28/01/2025,1968954,190319,166011,24308,1778635,N,NULL,9,16/12/2020,NULL
252992,175657,51,28/02/2025,1800868,190319,168086,22233,1610549,N,NULL,9,16/12/2020,NULL
252993,175657,52,28/03/2025,1630680,190319,170188,20132,1440361,N,NULL,9,16/12/2020,NULL
252994,175657,53,28/04/2025,1458365,190319,172315,18005,1268046,N,NULL,9,16/12/2020,NULL
252995,175657,54,28/05/2025,1283896,190319,174469,15851,1093577,N,NULL,9,16/12/2020,NULL
252996,175657,55,28/06/2025,1107246,190319,176650,13670,916927,N,NULL,9,16/12/2020,NULL
252997,175657,56,28/07/2025,928388,190319,178858,11462,738069,N,NULL,9,16/12/2020,NULL
252998,175657,57,28/08/2025,747294,190319,181094,9226,556975,N,NULL,9,16/12/2020,NULL
252999,175657,58,28/09/2025,563937,190319,183357,6962,373618,N,NULL,9,16/12/2020,NULL
253000,175657,59,28/10/2025,378288,190319,185649,4670,187969,N,NULL,9,16/12/2020,NULL
253001,175657,60,28/11/2025,190318,190319,187969,2350,0,N,NULL,9,16/12/2020,NULL
253002,175658,1,30/12/2020,16200000,445292,245292,200000,15754708,N,NULL,9,16/12/2020,NULL
253003,175658,2,30/01/2021,15951642,445292,248358,196934,15506350,N,NULL,9,16/12/2020,NULL
253004,175658,3,28/02/2021,15700179,445292,251463,193829,15254887,N,NULL,9,16/12/2020,NULL
253005,175658,4,28/03/2021,15445573,445292,254606,190686,15000281,N,NULL,9,16/12/2020,NULL
253006,175658,5,28/04/2021,15187785,445292,257788,187504,14742493,N,NULL,9,16/12/2020,NULL
253007,175658,6,28/05/2021,14926774,445292,261011,184281,14481482,N,NULL,9,16/12/2020,NULL
253008,175658,7,28/06/2021,14662501,445292,264273,181019,14217209,N,NULL,9,16/12/2020,NULL
253009,175658,8,28/07/2021,14394924,445292,267577,177715,13949632,N,NULL,9,16/12/2020,NULL
253010,175658,9,28/08/2021,14124002,445292,270922,174370,13678710,N,NULL,9,16/12/2020,NULL
253011,175658,10,28/09/2021,13849694,445292,274308,170984,13404402,N,NULL,9,16/12/2020,NULL
253012,175658,11,28/10/2021,13571957,445292,277737,167555,13126665,N,NULL,9,16/12/2020,NULL
253013,175658,12,28/11/2021,13290748,445292,281209,164083,12845456,N,NULL,9,16/12/2020,NULL
253014,175658,13,28/12/2021,13006024,445292,284724,160568,12560732,N,NULL,9,16/12/2020,NULL
253015,175658,14,28/01/2022,12717741,445292,288283,157009,12272449,N,NULL,9,16/12/2020,NULL
253016,175658,15,28/02/2022,12425855,445292,291886,153406,11980563,N,NULL,9,16/12/2020,NULL
253017,175658,16,28/03/2022,12130320,445292,295535,149757,11685028,N,NULL,9,16/12/2020,NULL
253018,175658,17,28/04/2022,11831091,445292,299229,146063,11385799,N,NULL,9,16/12/2020,NULL
253019,175658,18,28/05/2022,11528122,445292,302969,142322,11082830,N,NULL,9,16/12/2020,NULL
253020,175658,19,28/06/2022,11221365,445292,306757,138535,10776073,N,NULL,9,16/12/2020,NULL
253021,175658,20,28/07/2022,10910774,445292,310591,134701,10465482,N,NULL,9,16/12/2020,NULL
253022,175658,21,28/08/2022,10596301,445292,314473,130819,10151009,N,NULL,9,16/12/2020,NULL
253023,175658,22,28/09/2022,10277897,445292,318404,126888,9832605,N,NULL,9,16/12/2020,NULL
253024,175658,23,28/10/2022,9955513,445292,322384,122908,9510221,N,NULL,9,16/12/2020,NULL
253025,175658,24,28/11/2022,9629099,445292,326414,118878,9183807,N,NULL,9,16/12/2020,NULL
253026,175658,25,28/12/2022,9298605,445292,330494,114798,8853313,N,NULL,9,16/12/2020,NULL
253027,175658,26,28/01/2023,8963979,445292,334626,110666,8518687,N,NULL,9,16/12/2020,NULL
253028,175658,27,28/02/2023,8625171,445292,338808,106484,8179879,N,NULL,9,16/12/2020,NULL
253029,175658,28,28/03/2023,8282127,445292,343044,102248,7836835,N,NULL,9,16/12/2020,NULL
253030,175658,29,28/04/2023,7934795,445292,347332,97960,7489503,N,NULL,9,16/12/2020,NULL
253031,175658,30,28/05/2023,7583122,445292,351673,93619,7137830,N,NULL,9,16/12/2020,NULL
253032,175658,31,28/06/2023,7227053,445292,356069,89223,6781761,N,NULL,9,16/12/2020,NULL
253033,175658,32,28/07/2023,6866533,445292,360520,84772,6421241,N,NULL,9,16/12/2020,NULL
253034,175658,33,28/08/2023,6501507,445292,365026,80266,6056215,N,NULL,9,16/12/2020,NULL
253035,175658,34,28/09/2023,6131918,445292,369589,75703,5686626,N,NULL,9,16/12/2020,NULL
253036,175658,35,28/10/2023,5757709,445292,374209,71083,5312417,N,NULL,9,16/12/2020,NULL
253037,175658,36,28/11/2023,5378822,445292,378887,66405,4933530,N,NULL,9,16/12/2020,NULL
253038,175658,37,28/12/2023,4995199,445292,383623,61669,4549907,N,NULL,9,16/12/2020,NULL
253039,175658,38,28/01/2024,4606781,445292,388418,56874,4161489,N,NULL,9,16/12/2020,NULL
253040,175658,39,28/02/2024,4213508,445292,393273,52019,3768216,N,NULL,9,16/12/2020,NULL
253041,175658,40,28/03/2024,3815319,445292,398189,47103,3370027,N,NULL,9,16/12/2020,NULL
253042,175658,41,28/04/2024,3412152,445292,403167,42125,2966860,N,NULL,9,16/12/2020,NULL
253043,175658,42,28/05/2024,3003946,445292,408206,37086,2558654,N,NULL,9,16/12/2020,NULL
253044,175658,43,28/06/2024,2590637,445292,413309,31983,2145345,N,NULL,9,16/12/2020,NULL
253045,175658,44,28/07/2024,2172162,445292,418475,26817,1726870,N,NULL,9,16/12/2020,NULL
253046,175658,45,28/08/2024,1748456,445292,423706,21586,1303164,N,NULL,9,16/12/2020,NULL
253047,175658,46,28/09/2024,1319454,445292,429002,16290,874162,N,NULL,9,16/12/2020,NULL
253048,175658,47,28/10/2024,885089,445292,434365,10927,439797,N,NULL,9,16/12/2020,NULL
253049,175658,48,28/11/2024,445294,445292,439797,5497,0,N,NULL,9,16/12/2020,NULL
253050,175659,1,30/12/2020,16200000,445292,245292,200000,15754708,N,NULL,9,16/12/2020,NULL
253051,175659,2,30/01/2021,15951642,445292,248358,196934,15506350,N,NULL,9,16/12/2020,NULL
253052,175659,3,28/02/2021,15700179,445292,251463,193829,15254887,N,NULL,9,16/12/2020,NULL
253053,175659,4,28/03/2021,15445573,445292,254606,190686,15000281,N,NULL,9,16/12/2020,NULL
253054,175659,5,28/04/2021,15187785,445292,257788,187504,14742493,N,NULL,9,16/12/2020,NULL
253055,175659,6,28/05/2021,14926774,445292,261011,184281,14481482,N,NULL,9,16/12/2020,NULL
253056,175659,7,28/06/2021,14662501,445292,264273,181019,14217209,N,NULL,9,16/12/2020,NULL
253057,175659,8,28/07/2021,14394924,445292,267577,177715,13949632,N,NULL,9,16/12/2020,NULL
253058,175659,9,28/08/2021,14124002,445292,270922,174370,13678710,N,NULL,9,16/12/2020,NULL
253059,175659,10,28/09/2021,13849694,445292,274308,170984,13404402,N,NULL,9,16/12/2020,NULL
253060,175659,11,28/10/2021,13571957,445292,277737,167555,13126665,N,NULL,9,16/12/2020,NULL
253061,175659,12,28/11/2021,13290748,445292,281209,164083,12845456,N,NULL,9,16/12/2020,NULL
253062,175659,13,28/12/2021,13006024,445292,284724,160568,12560732,N,NULL,9,16/12/2020,NULL
253063,175659,14,28/01/2022,12717741,445292,288283,157009,12272449,N,NULL,9,16/12/2020,NULL
253064,175659,15,28/02/2022,12425855,445292,291886,153406,11980563,N,NULL,9,16/12/2020,NULL
253065,175659,16,28/03/2022,12130320,445292,295535,149757,11685028,N,NULL,9,16/12/2020,NULL
253066,175659,17,28/04/2022,11831091,445292,299229,146063,11385799,N,NULL,9,16/12/2020,NULL
253067,175659,18,28/05/2022,11528122,445292,302969,142322,11082830,N,NULL,9,16/12/2020,NULL
253068,175659,19,28/06/2022,11221365,445292,306757,138535,10776073,N,NULL,9,16/12/2020,NULL
253069,175659,20,28/07/2022,10910774,445292,310591,134701,10465482,N,NULL,9,16/12/2020,NULL
253070,175659,21,28/08/2022,10596301,445292,314473,130819,10151009,N,NULL,9,16/12/2020,NULL
253071,175659,22,28/09/2022,10277897,445292,318404,126888,9832605,N,NULL,9,16/12/2020,NULL
253072,175659,23,28/10/2022,9955513,445292,322384,122908,9510221,N,NULL,9,16/12/2020,NULL
253073,175659,24,28/11/2022,9629099,445292,326414,118878,9183807,N,NULL,9,16/12/2020,NULL
253074,175659,25,28/12/2022,9298605,445292,330494,114798,8853313,N,NULL,9,16/12/2020,NULL
253075,175659,26,28/01/2023,8963979,445292,334626,110666,8518687,N,NULL,9,16/12/2020,NULL
253076,175659,27,28/02/2023,8625171,445292,338808,106484,8179879,N,NULL,9,16/12/2020,NULL
253077,175659,28,28/03/2023,8282127,445292,343044,102248,7836835,N,NULL,9,16/12/2020,NULL
253078,175659,29,28/04/2023,7934795,445292,347332,97960,7489503,N,NULL,9,16/12/2020,NULL
253079,175659,30,28/05/2023,7583122,445292,351673,93619,7137830,N,NULL,9,16/12/2020,NULL
253080,175659,31,28/06/2023,7227053,445292,356069,89223,6781761,N,NULL,9,16/12/2020,NULL
253081,175659,32,28/07/2023,6866533,445292,360520,84772,6421241,N,NULL,9,16/12/2020,NULL
253082,175659,33,28/08/2023,6501507,445292,365026,80266,6056215,N,NULL,9,16/12/2020,NULL
253083,175659,34,28/09/2023,6131918,445292,369589,75703,5686626,N,NULL,9,16/12/2020,NULL
253084,175659,35,28/10/2023,5757709,445292,374209,71083,5312417,N,NULL,9,16/12/2020,NULL
253085,175659,36,28/11/2023,5378822,445292,378887,66405,4933530,N,NULL,9,16/12/2020,NULL
253086,175659,37,28/12/2023,4995199,445292,383623,61669,4549907,N,NULL,9,16/12/2020,NULL
253087,175659,38,28/01/2024,4606781,445292,388418,56874,4161489,N,NULL,9,16/12/2020,NULL
253088,175659,39,28/02/2024,4213508,445292,393273,52019,3768216,N,NULL,9,16/12/2020,NULL
253089,175659,40,28/03/2024,3815319,445292,398189,47103,3370027,N,NULL,9,16/12/2020,NULL
253090,175659,41,28/04/2024,3412152,445292,403167,42125,2966860,N,NULL,9,16/12/2020,NULL
253091,175659,42,28/05/2024,3003946,445292,408206,37086,2558654,N,NULL,9,16/12/2020,NULL
253092,175659,43,28/06/2024,2590637,445292,413309,31983,2145345,N,NULL,9,16/12/2020,NULL
253093,175659,44,28/07/2024,2172162,445292,418475,26817,1726870,N,NULL,9,16/12/2020,NULL
253094,175659,45,28/08/2024,1748456,445292,423706,21586,1303164,N,NULL,9,16/12/2020,NULL
253095,175659,46,28/09/2024,1319454,445292,429002,16290,874162,N,NULL,9,16/12/2020,NULL
253096,175659,47,28/10/2024,885089,445292,434365,10927,439797,N,NULL,9,16/12/2020,NULL
253097,175659,48,28/11/2024,445294,445292,439797,5497,0,N,NULL,9,16/12/2020,NULL
253098,175660,1,30/12/2020,8100000,387893,287893,100000,7712107,N,NULL,9,16/12/2020,NULL
253099,175660,2,30/01/2021,7808508,387893,291492,96401,7420615,N,NULL,9,16/12/2020,NULL
253100,175660,3,28/02/2021,7513373,387893,295135,92758,7125480,N,NULL,9,16/12/2020,NULL
253101,175660,4,28/03/2021,7214548,387893,298825,89068,6826655,N,NULL,9,16/12/2020,NULL
253102,175660,5,28/04/2021,6911988,387893,302560,85333,6524095,N,NULL,9,16/12/2020,NULL
253103,175660,6,28/05/2021,6605646,387893,306342,81551,6217753,N,NULL,9,16/12/2020,NULL
253104,175660,7,28/06/2021,6295475,387893,310171,77722,5907582,N,NULL,9,16/12/2020,NULL
253105,175660,8,28/07/2021,5981427,387893,314048,73845,5593534,N,NULL,9,16/12/2020,NULL
253106,175660,9,28/08/2021,5663453,387893,317974,69919,5275560,N,NULL,9,16/12/2020,NULL
253107,175660,10,28/09/2021,5341504,387893,321949,65944,4953611,N,NULL,9,16/12/2020,NULL
253108,175660,11,28/10/2021,5015531,387893,325973,61920,4627638,N,NULL,9,16/12/2020,NULL
253109,175660,12,28/11/2021,4685483,387893,330048,57845,4297590,N,NULL,9,16/12/2020,NULL
253110,175660,13,28/12/2021,4351310,387893,334173,53720,3963417,N,NULL,9,16/12/2020,NULL
253111,175660,14,28/01/2022,4012960,387893,338350,49543,3625067,N,NULL,9,16/12/2020,NULL
253112,175660,15,28/02/2022,3670380,387893,342580,45313,3282487,N,NULL,9,16/12/2020,NULL
253113,175660,16,28/03/2022,3323518,387893,346862,41031,2935625,N,NULL,9,16/12/2020,NULL
253114,175660,17,28/04/2022,2972320,387893,351198,36695,2584427,N,NULL,9,16/12/2020,NULL
253115,175660,18,28/05/2022,2616732,387893,355588,32305,2228839,N,NULL,9,16/12/2020,NULL
253116,175660,19,28/06/2022,2256699,387893,360033,27860,1868806,N,NULL,9,16/12/2020,NULL
253117,175660,20,28/07/2022,1892166,387893,364533,23360,1504273,N,NULL,9,16/12/2020,NULL
253118,175660,21,28/08/2022,1523076,387893,369090,18803,1135183,N,NULL,9,16/12/2020,NULL
253119,175660,22,28/09/2022,1149373,387893,373703,14190,761480,N,NULL,9,16/12/2020,NULL
253120,175660,23,28/10/2022,770998,387893,378375,9518,383105,N,NULL,9,16/12/2020,NULL
253121,175660,24,28/11/2022,387894,387893,383105,4789,0,N,NULL,9,16/12/2020,NULL
253122,175661,1,30/12/2020,8100000,190319,90319,100000,7909681,N,NULL,9,16/12/2020,NULL
253123,175661,2,30/01/2021,8008552,190319,91448,98871,7818233,N,NULL,9,16/12/2020,NULL
253124,175661,3,28/02/2021,7915960,190319,92592,97728,7725641,N,NULL,9,16/12/2020,NULL
253125,175661,4,28/03/2021,7822211,190319,93749,96571,7631892,N,NULL,9,16/12/2020,NULL
253126,175661,5,28/04/2021,7727290,190319,94921,95399,7536971,N,NULL,9,16/12/2020,NULL
253127,175661,6,28/05/2021,7631183,190319,96107,94212,7440864,N,NULL,9,16/12/2020,NULL
253128,175661,7,28/06/2021,7533874,190319,97309,93011,7343555,N,NULL,9,16/12/2020,NULL
253129,175661,8,28/07/2021,7435349,190319,98525,91794,7245030,N,NULL,9,16/12/2020,NULL
253130,175661,9,28/08/2021,7335592,190319,99757,90563,7145273,N,NULL,9,16/12/2020,NULL
253131,175661,10,28/09/2021,7234588,190319,101004,89316,7044269,N,NULL,9,16/12/2020,NULL
253132,175661,11,28/10/2021,7132322,190319,102266,88053,6942003,N,NULL,9,16/12/2020,NULL
253133,175661,12,28/11/2021,7028778,190319,103544,86775,6838459,N,NULL,9,16/12/2020,NULL
253134,175661,13,28/12/2021,6923939,190319,104839,85481,6733620,N,NULL,9,16/12/2020,NULL
253135,175661,14,28/01/2022,6817790,190319,106149,84170,6627471,N,NULL,9,16/12/2020,NULL
253136,175661,15,28/02/2022,6710314,190319,107476,82843,6519995,N,NULL,9,16/12/2020,NULL
253137,175661,16,28/03/2022,6601495,190319,108819,81500,6411176,N,NULL,9,16/12/2020,NULL
253138,175661,17,28/04/2022,6491315,190319,110180,80140,6300996,N,NULL,9,16/12/2020,NULL
253139,175661,18,28/05/2022,6379758,190319,111557,78762,6189439,N,NULL,9,16/12/2020,NULL
253140,175661,19,28/06/2022,6266807,190319,112951,77368,6076488,N,NULL,9,16/12/2020,NULL
253141,175661,20,28/07/2022,6152444,190319,114363,75956,5962125,N,NULL,9,16/12/2020,NULL
253142,175661,21,28/08/2022,6036651,190319,115793,74527,5846332,N,NULL,9,16/12/2020,NULL
253143,175661,22,28/09/2022,5919411,190319,117240,73079,5729092,N,NULL,9,16/12/2020,NULL
253144,175661,23,28/10/2022,5800705,190319,118706,71614,5610386,N,NULL,9,16/12/2020,NULL
253145,175661,24,28/11/2022,5680515,190319,120190,70130,5490196,N,NULL,9,16/12/2020,NULL
253146,175661,25,28/12/2022,5558823,190319,121692,68627,5368504,N,NULL,9,16/12/2020,NULL
253147,175661,26,28/01/2023,5435610,190319,123213,67106,5245291,N,NULL,9,16/12/2020,NULL
253148,175661,27,28/02/2023,5310857,190319,124753,65566,5120538,N,NULL,9,16/12/2020,NULL
253149,175661,28,28/03/2023,5184544,190319,126313,64007,4994225,N,NULL,9,16/12/2020,NULL
253150,175661,29,28/04/2023,5056652,190319,127892,62428,4866333,N,NULL,9,16/12/2020,NULL
253151,175661,30,28/05/2023,4927162,190319,129490,60829,4736843,N,NULL,9,16/12/2020,NULL
253152,175661,31,28/06/2023,4796053,190319,131109,59211,4605734,N,NULL,9,16/12/2020,NULL
253153,175661,32,28/07/2023,4663305,190319,132748,57572,4472986,N,NULL,9,16/12/2020,NULL
253154,175661,33,28/08/2023,4528898,190319,134407,55912,4338579,N,NULL,9,16/12/2020,NULL
253155,175661,34,28/09/2023,4392811,190319,136087,54232,4202492,N,NULL,9,16/12/2020,NULL
253156,175661,35,28/10/2023,4255023,190319,137788,52531,4064704,N,NULL,9,16/12/2020,NULL
253157,175661,36,28/11/2023,4115512,190319,139511,50809,3925193,N,NULL,9,16/12/2020,NULL
253158,175661,37,28/12/2023,3974257,190319,141255,49065,3783938,N,NULL,9,16/12/2020,NULL
253159,175661,38,28/01/2024,3831237,190319,143020,47299,3640918,N,NULL,9,16/12/2020,NULL
253160,175661,39,28/02/2024,3686429,190319,144808,45511,3496110,N,NULL,9,16/12/2020,NULL
253161,175661,40,28/03/2024,3539811,190319,146618,43701,3349492,N,NULL,9,16/12/2020,NULL
253162,175661,41,28/04/2024,3391360,190319,148451,41869,3201041,N,NULL,9,16/12/2020,NULL
253163,175661,42,28/05/2024,3241054,190319,150306,40013,3050735,N,NULL,9,16/12/2020,NULL
253164,175661,43,28/06/2024,3088869,190319,152185,38134,2898550,N,NULL,9,16/12/2020,NULL
253165,175661,44,28/07/2024,2934781,190319,154088,36232,2744462,N,NULL,9,16/12/2020,NULL
253166,175661,45,28/08/2024,2778767,190319,156014,34306,2588448,N,NULL,9,16/12/2020,NULL
253167,175661,46,28/09/2024,2620803,190319,157964,32356,2430484,N,NULL,9,16/12/2020,NULL
253168,175661,47,28/10/2024,2460865,190319,159938,30381,2270546,N,NULL,9,16/12/2020,NULL
253169,175661,48,28/11/2024,2298927,190319,161938,28382,2108608,N,NULL,9,16/12/2020,NULL
253170,175661,49,28/12/2024,2134965,190319,163962,26358,1944646,N,NULL,9,16/12/2020,NULL
253171,175661,50,28/01/2025,1968954,190319,166011,24308,1778635,N,NULL,9,16/12/2020,NULL
253172,175661,51,28/02/2025,1800868,190319,168086,22233,1610549,N,NULL,9,16/12/2020,NULL
253173,175661,52,28/03/2025,1630680,190319,170188,20132,1440361,N,NULL,9,16/12/2020,NULL
253174,175661,53,28/04/2025,1458365,190319,172315,18005,1268046,N,NULL,9,16/12/2020,NULL
253175,175661,54,28/05/2025,1283896,190319,174469,15851,1093577,N,NULL,9,16/12/2020,NULL
253176,175661,55,28/06/2025,1107246,190319,176650,13670,916927,N,NULL,9,16/12/2020,NULL
253177,175661,56,28/07/2025,928388,190319,178858,11462,738069,N,NULL,9,16/12/2020,NULL
253178,175661,57,28/08/2025,747294,190319,181094,9226,556975,N,NULL,9,16/12/2020,NULL
253179,175661,58,28/09/2025,563937,190319,183357,6962,373618,N,NULL,9,16/12/2020,NULL
253180,175661,59,28/10/2025,378288,190319,185649,4670,187969,N,NULL,9,16/12/2020,NULL
253181,175661,60,28/11/2025,190318,190319,187969,2350,0,N,NULL,9,16/12/2020,NULL
253182,175662,1,30/12/2020,16200000,380639,180639,200000,15819361,N,NULL,9,16/12/2020,NULL
253183,175662,2,30/01/2021,16017103,380639,182897,197742,15636464,N,NULL,9,16/12/2020,NULL
253184,175662,3,28/02/2021,15831920,380639,185183,195456,15451281,N,NULL,9,16/12/2020,NULL
253185,175662,4,28/03/2021,15644422,380639,187498,193141,15263783,N,NULL,9,16/12/2020,NULL
253186,175662,5,28/04/2021,15454580,380639,189842,190797,15073941,N,NULL,9,16/12/2020,NULL
253187,175662,6,28/05/2021,15262365,380639,192215,188424,14881726,N,NULL,9,16/12/2020,NULL
253188,175662,7,28/06/2021,15067748,380639,194617,186022,14687109,N,NULL,9,16/12/2020,NULL
253189,175662,8,28/07/2021,14870698,380639,197050,183589,14490059,N,NULL,9,16/12/2020,NULL
253190,175662,9,28/08/2021,14671185,380639,199513,181126,14290546,N,NULL,9,16/12/2020,NULL
253191,175662,10,28/09/2021,14469178,380639,202007,178632,14088539,N,NULL,9,16/12/2020,NULL
253192,175662,11,28/10/2021,14264646,380639,204532,176107,13884007,N,NULL,9,16/12/2020,NULL
253193,175662,12,28/11/2021,14057557,380639,207089,173550,13676918,N,NULL,9,16/12/2020,NULL
253194,175662,13,28/12/2021,13847880,380639,209677,170961,13467241,N,NULL,9,16/12/2020,NULL
253195,175662,14,28/01/2022,13635582,380639,212298,168341,13254943,N,NULL,9,16/12/2020,NULL
253196,175662,15,28/02/2022,13420630,380639,214952,165687,13039991,N,NULL,9,16/12/2020,NULL
253197,175662,16,28/03/2022,13202991,380639,217639,163000,12822352,N,NULL,9,16/12/2020,NULL
253198,175662,17,28/04/2022,12982632,380639,220359,160279,12601993,N,NULL,9,16/12/2020,NULL
253199,175662,18,28/05/2022,12759518,380639,223114,157525,12378879,N,NULL,9,16/12/2020,NULL
253200,175662,19,28/06/2022,12533615,380639,225903,154736,12152976,N,NULL,9,16/12/2020,NULL
253201,175662,20,28/07/2022,12304888,380639,228727,151912,11924249,N,NULL,9,16/12/2020,NULL
253202,175662,21,28/08/2022,12073302,380639,231586,149053,11692663,N,NULL,9,16/12/2020,NULL
253203,175662,22,28/09/2022,11838821,380639,234481,146158,11458182,N,NULL,9,16/12/2020,NULL
253204,175662,23,28/10/2022,11601409,380639,237412,143227,11220770,N,NULL,9,16/12/2020,NULL
253205,175662,24,28/11/2022,11361030,380639,240379,140260,10980391,N,NULL,9,16/12/2020,NULL
253206,175662,25,28/12/2022,11117646,380639,243384,137255,10737007,N,NULL,9,16/12/2020,NULL
253207,175662,26,28/01/2023,10871220,380639,246426,134213,10490581,N,NULL,9,16/12/2020,NULL
253208,175662,27,28/02/2023,10621713,380639,249507,131132,10241074,N,NULL,9,16/12/2020,NULL
253209,175662,28,28/03/2023,10369088,380639,252625,128013,9988449,N,NULL,9,16/12/2020,NULL
253210,175662,29,28/04/2023,10113305,380639,255783,124856,9732666,N,NULL,9,16/12/2020,NULL
253211,175662,30,28/05/2023,9854324,380639,258981,121658,9473685,N,NULL,9,16/12/2020,NULL
253212,175662,31,28/06/2023,9592106,380639,262218,118421,9211467,N,NULL,9,16/12/2020,NULL
253213,175662,32,28/07/2023,9326610,380639,265496,115143,8945971,N,NULL,9,16/12/2020,NULL
253214,175662,33,28/08/2023,9057796,380639,268814,111825,8677157,N,NULL,9,16/12/2020,NULL
253215,175662,34,28/09/2023,8785622,380639,272174,108464,8404983,N,NULL,9,16/12/2020,NULL
253216,175662,35,28/10/2023,8510045,380639,275577,105062,8129406,N,NULL,9,16/12/2020,NULL
253217,175662,36,28/11/2023,8231024,380639,279021,101618,7850385,N,NULL,9,16/12/2020,NULL
253218,175662,37,28/12/2023,7948515,380639,282509,98130,7567876,N,NULL,9,16/12/2020,NULL
253219,175662,38,28/01/2024,7662475,380639,286040,94598,7281836,N,NULL,9,16/12/2020,NULL
253220,175662,39,28/02/2024,7372859,380639,289616,91023,6992220,N,NULL,9,16/12/2020,NULL
253221,175662,40,28/03/2024,7079623,380639,293236,87403,6698984,N,NULL,9,16/12/2020,NULL
253222,175662,41,28/04/2024,6782721,380639,296902,83737,6402082,N,NULL,9,16/12/2020,NULL
253223,175662,42,28/05/2024,6482108,380639,300613,80026,6101469,N,NULL,9,16/12/2020,NULL
253224,175662,43,28/06/2024,6177737,380639,304371,76268,5797098,N,NULL,9,16/12/2020,NULL
253225,175662,44,28/07/2024,5869562,380639,308175,72464,5488923,N,NULL,9,16/12/2020,NULL
253226,175662,45,28/08/2024,5557535,380639,312027,68612,5176896,N,NULL,9,16/12/2020,NULL
253227,175662,46,28/09/2024,5241607,380639,315928,64711,4860968,N,NULL,9,16/12/2020,NULL
253228,175662,47,28/10/2024,4921730,380639,319877,60762,4541091,N,NULL,9,16/12/2020,NULL
253229,175662,48,28/11/2024,4597855,380639,323875,56764,4217216,N,NULL,9,16/12/2020,NULL
253230,175662,49,28/12/2024,4269931,380639,327924,52715,3889292,N,NULL,9,16/12/2020,NULL
253231,175662,50,28/01/2025,3937908,380639,332023,48616,3557269,N,NULL,9,16/12/2020,NULL
253232,175662,51,28/02/2025,3601735,380639,336173,44466,3221096,N,NULL,9,16/12/2020,NULL
253233,175662,52,28/03/2025,3261360,380639,340375,40264,2880721,N,NULL,9,16/12/2020,NULL
253234,175662,53,28/04/2025,2916730,380639,344630,36009,2536091,N,NULL,9,16/12/2020,NULL
253235,175662,54,28/05/2025,2567792,380639,348938,31701,2187153,N,NULL,9,16/12/2020,NULL
253236,175662,55,28/06/2025,2214493,380639,353299,27339,1833854,N,NULL,9,16/12/2020,NULL
253237,175662,56,28/07/2025,1856777,380639,357716,22923,1476138,N,NULL,9,16/12/2020,NULL
253238,175662,57,28/08/2025,1494590,380639,362187,18452,1113951,N,NULL,9,16/12/2020,NULL
253239,175662,58,28/09/2025,1127876,380639,366714,13924,747237,N,NULL,9,16/12/2020,NULL
253240,175662,59,28/10/2025,756578,380639,371298,9340,375939,N,NULL,9,16/12/2020,NULL
253241,175662,60,28/11/2025,380638,380639,375939,4699,0,N,NULL,9,16/12/2020,NULL
253242,175663,1,30/12/2020,8100000,1392270,1292270,100000,6707730,N,NULL,9,16/12/2020,NULL
253243,175663,2,30/01/2021,6791576,1392270,1308424,83847,5399306,N,NULL,9,16/12/2020,NULL
253244,175663,3,28/02/2021,5466797,1392270,1324779,67491,4074527,N,NULL,9,16/12/2020,NULL
253245,175663,4,28/03/2021,4125458,1392270,1341339,50932,2733188,N,NULL,9,16/12/2020,NULL
253246,175663,5,28/04/2021,2767352,1392270,1358106,34165,1375082,N,NULL,9,16/12/2020,NULL
253247,175663,6,28/05/2021,1392270,1392270,1375082,17189,0,N,NULL,9,16/12/2020,NULL
253248,175664,1,30/12/2020,16200000,380639,180639,200000,15819361,N,NULL,9,16/12/2020,NULL
253249,175664,2,30/01/2021,16017103,380639,182897,197742,15636464,N,NULL,9,16/12/2020,NULL
253250,175664,3,28/02/2021,15831920,380639,185183,195456,15451281,N,NULL,9,16/12/2020,NULL
253251,175664,4,28/03/2021,15644422,380639,187498,193141,15263783,N,NULL,9,16/12/2020,NULL
253252,175664,5,28/04/2021,15454580,380639,189842,190797,15073941,N,NULL,9,16/12/2020,NULL
253253,175664,6,28/05/2021,15262365,380639,192215,188424,14881726,N,NULL,9,16/12/2020,NULL
253254,175664,7,28/06/2021,15067748,380639,194617,186022,14687109,N,NULL,9,16/12/2020,NULL
253255,175664,8,28/07/2021,14870698,380639,197050,183589,14490059,N,NULL,9,16/12/2020,NULL
253256,175664,9,28/08/2021,14671185,380639,199513,181126,14290546,N,NULL,9,16/12/2020,NULL
253257,175664,10,28/09/2021,14469178,380639,202007,178632,14088539,N,NULL,9,16/12/2020,NULL
253258,175664,11,28/10/2021,14264646,380639,204532,176107,13884007,N,NULL,9,16/12/2020,NULL
253259,175664,12,28/11/2021,14057557,380639,207089,173550,13676918,N,NULL,9,16/12/2020,NULL
253260,175664,13,28/12/2021,13847880,380639,209677,170961,13467241,N,NULL,9,16/12/2020,NULL
253261,175664,14,28/01/2022,13635582,380639,212298,168341,13254943,N,NULL,9,16/12/2020,NULL
253262,175664,15,28/02/2022,13420630,380639,214952,165687,13039991,N,NULL,9,16/12/2020,NULL
253263,175664,16,28/03/2022,13202991,380639,217639,163000,12822352,N,NULL,9,16/12/2020,NULL
253264,175664,17,28/04/2022,12982632,380639,220359,160279,12601993,N,NULL,9,16/12/2020,NULL
253265,175664,18,28/05/2022,12759518,380639,223114,157525,12378879,N,NULL,9,16/12/2020,NULL
253266,175664,19,28/06/2022,12533615,380639,225903,154736,12152976,N,NULL,9,16/12/2020,NULL
253267,175664,20,28/07/2022,12304888,380639,228727,151912,11924249,N,NULL,9,16/12/2020,NULL
253268,175664,21,28/08/2022,12073302,380639,231586,149053,11692663,N,NULL,9,16/12/2020,NULL
253269,175664,22,28/09/2022,11838821,380639,234481,146158,11458182,N,NULL,9,16/12/2020,NULL
253270,175664,23,28/10/2022,11601409,380639,237412,143227,11220770,N,NULL,9,16/12/2020,NULL
253271,175664,24,28/11/2022,11361030,380639,240379,140260,10980391,N,NULL,9,16/12/2020,NULL
253272,175664,25,28/12/2022,11117646,380639,243384,137255,10737007,N,NULL,9,16/12/2020,NULL
253273,175664,26,28/01/2023,10871220,380639,246426,134213,10490581,N,NULL,9,16/12/2020,NULL
253274,175664,27,28/02/2023,10621713,380639,249507,131132,10241074,N,NULL,9,16/12/2020,NULL
253275,175664,28,28/03/2023,10369088,380639,252625,128013,9988449,N,NULL,9,16/12/2020,NULL
253276,175664,29,28/04/2023,10113305,380639,255783,124856,9732666,N,NULL,9,16/12/2020,NULL
253277,175664,30,28/05/2023,9854324,380639,258981,121658,9473685,N,NULL,9,16/12/2020,NULL
253278,175664,31,28/06/2023,9592106,380639,262218,118421,9211467,N,NULL,9,16/12/2020,NULL
253279,175664,32,28/07/2023,9326610,380639,265496,115143,8945971,N,NULL,9,16/12/2020,NULL
253280,175664,33,28/08/2023,9057796,380639,268814,111825,8677157,N,NULL,9,16/12/2020,NULL
253281,175664,34,28/09/2023,8785622,380639,272174,108464,8404983,N,NULL,9,16/12/2020,NULL
253282,175664,35,28/10/2023,8510045,380639,275577,105062,8129406,N,NULL,9,16/12/2020,NULL
253283,175664,36,28/11/2023,8231024,380639,279021,101618,7850385,N,NULL,9,16/12/2020,NULL
253284,175664,37,28/12/2023,7948515,380639,282509,98130,7567876,N,NULL,9,16/12/2020,NULL
253285,175664,38,28/01/2024,7662475,380639,286040,94598,7281836,N,NULL,9,16/12/2020,NULL
253286,175664,39,28/02/2024,7372859,380639,289616,91023,6992220,N,NULL,9,16/12/2020,NULL
253287,175664,40,28/03/2024,7079623,380639,293236,87403,6698984,N,NULL,9,16/12/2020,NULL
253288,175664,41,28/04/2024,6782721,380639,296902,83737,6402082,N,NULL,9,16/12/2020,NULL
253289,175664,42,28/05/2024,6482108,380639,300613,80026,6101469,N,NULL,9,16/12/2020,NULL
253290,175664,43,28/06/2024,6177737,380639,304371,76268,5797098,N,NULL,9,16/12/2020,NULL
253291,175664,44,28/07/2024,5869562,380639,308175,72464,5488923,N,NULL,9,16/12/2020,NULL
253292,175664,45,28/08/2024,5557535,380639,312027,68612,5176896,N,NULL,9,16/12/2020,NULL
253293,175664,46,28/09/2024,5241607,380639,315928,64711,4860968,N,NULL,9,16/12/2020,NULL
253294,175664,47,28/10/2024,4921730,380639,319877,60762,4541091,N,NULL,9,16/12/2020,NULL
253295,175664,48,28/11/2024,4597855,380639,323875,56764,4217216,N,NULL,9,16/12/2020,NULL
253296,175664,49,28/12/2024,4269931,380639,327924,52715,3889292,N,NULL,9,16/12/2020,NULL
253297,175664,50,28/01/2025,3937908,380639,332023,48616,3557269,N,NULL,9,16/12/2020,NULL
253298,175664,51,28/02/2025,3601735,380639,336173,44466,3221096,N,NULL,9,16/12/2020,NULL
253299,175664,52,28/03/2025,3261360,380639,340375,40264,2880721,N,NULL,9,16/12/2020,NULL
253300,175664,53,28/04/2025,2916730,380639,344630,36009,2536091,N,NULL,9,16/12/2020,NULL
253301,175664,54,28/05/2025,2567792,380639,348938,31701,2187153,N,NULL,9,16/12/2020,NULL
253302,175664,55,28/06/2025,2214493,380639,353299,27339,1833854,N,NULL,9,16/12/2020,NULL
253303,175664,56,28/07/2025,1856777,380639,357716,22923,1476138,N,NULL,9,16/12/2020,NULL
253304,175664,57,28/08/2025,1494590,380639,362187,18452,1113951,N,NULL,9,16/12/2020,NULL
253305,175664,58,28/09/2025,1127876,380639,366714,13924,747237,N,NULL,9,16/12/2020,NULL
253306,175664,59,28/10/2025,756578,380639,371298,9340,375939,N,NULL,9,16/12/2020,NULL
253307,175664,60,28/11/2025,380638,380639,375939,4699,0,N,NULL,9,16/12/2020,NULL
253308,175665,1,30/12/2020,8100000,277323,177323,100000,7822677,N,NULL,9,16/12/2020,NULL
253309,175665,2,30/01/2021,7920461,277323,179539,97783,7643138,N,NULL,9,16/12/2020,NULL
253310,175665,3,28/02/2021,7738678,277323,181783,95539,7461355,N,NULL,9,16/12/2020,NULL
253311,175665,4,28/03/2021,7554622,277323,184056,93267,7277299,N,NULL,9,16/12/2020,NULL
253312,175665,5,28/04/2021,7368266,277323,186356,90966,7090943,N,NULL,9,16/12/2020,NULL
253313,175665,6,28/05/2021,7179580,277323,188686,88637,6902257,N,NULL,9,16/12/2020,NULL
253314,175665,7,28/06/2021,6988536,277323,191044,86278,6711213,N,NULL,9,16/12/2020,NULL
253315,175665,8,28/07/2021,6795104,277323,193432,83890,6517781,N,NULL,9,16/12/2020,NULL
253316,175665,9,28/08/2021,6599254,277323,195850,81472,6321931,N,NULL,9,16/12/2020,NULL
253317,175665,10,28/09/2021,6400955,277323,198299,79024,6123632,N,NULL,9,16/12/2020,NULL
253318,175665,11,28/10/2021,6200178,277323,200777,76545,5922855,N,NULL,9,16/12/2020,NULL
253319,175665,12,28/11/2021,5996891,277323,203287,74036,5719568,N,NULL,9,16/12/2020,NULL
253320,175665,13,28/12/2021,5791063,277323,205828,71495,5513740,N,NULL,9,16/12/2020,NULL
253321,175665,14,28/01/2022,5582662,277323,208401,68922,5305339,N,NULL,9,16/12/2020,NULL
253322,175665,15,28/02/2022,5371656,277323,211006,66317,5094333,N,NULL,9,16/12/2020,NULL
253323,175665,16,28/03/2022,5158013,277323,213643,63679,4880690,N,NULL,9,16/12/2020,NULL
253324,175665,17,28/04/2022,4941699,277323,216314,61009,4664376,N,NULL,9,16/12/2020,NULL
253325,175665,18,28/05/2022,4722681,277323,219018,58305,4445358,N,NULL,9,16/12/2020,NULL
253326,175665,19,28/06/2022,4500925,277323,221756,55567,4223602,N,NULL,9,16/12/2020,NULL
253327,175665,20,28/07/2022,4276397,277323,224528,52795,3999074,N,NULL,9,16/12/2020,NULL
253328,175665,21,28/08/2022,4049063,277323,227334,49988,3771740,N,NULL,9,16/12/2020,NULL
253329,175665,22,28/09/2022,3818887,277323,230176,47147,3541564,N,NULL,9,16/12/2020,NULL
253330,175665,23,28/10/2022,3585834,277323,233053,44270,3308511,N,NULL,9,16/12/2020,NULL
253331,175665,24,28/11/2022,3349868,277323,235966,41356,3072545,N,NULL,9,16/12/2020,NULL
253332,175665,25,28/12/2022,3110952,277323,238916,38407,2833629,N,NULL,9,16/12/2020,NULL
253333,175665,26,28/01/2023,2869050,277323,241902,35420,2591727,N,NULL,9,16/12/2020,NULL
253334,175665,27,28/02/2023,2624124,277323,244926,32397,2346801,N,NULL,9,16/12/2020,NULL
253335,175665,28,28/03/2023,2376136,277323,247988,29335,2098813,N,NULL,9,16/12/2020,NULL
253336,175665,29,28/04/2023,2125049,277323,251087,26235,1847726,N,NULL,9,16/12/2020,NULL
253337,175665,30,28/05/2023,1870823,277323,254226,23097,1593500,N,NULL,9,16/12/2020,NULL
253338,175665,31,28/06/2023,1613419,277323,257404,19919,1336096,N,NULL,9,16/12/2020,NULL
253339,175665,32,28/07/2023,1352798,277323,260621,16701,1075475,N,NULL,9,16/12/2020,NULL
253340,175665,33,28/08/2023,1088919,277323,263879,13443,811596,N,NULL,9,16/12/2020,NULL
253341,175665,34,28/09/2023,821741,277323,267178,10145,544418,N,NULL,9,16/12/2020,NULL
253342,175665,35,28/10/2023,551224,277323,270517,6805,273901,N,NULL,9,16/12/2020,NULL
253343,175665,36,28/11/2023,277325,277323,273901,3424,0,N,NULL,9,16/12/2020,NULL
253344,175666,1,30/12/2020,8100000,190319,90319,100000,7909681,N,NULL,9,16/12/2020,NULL
253345,175666,2,30/01/2021,8008552,190319,91448,98871,7818233,N,NULL,9,16/12/2020,NULL
253346,175666,3,28/02/2021,7915960,190319,92592,97728,7725641,N,NULL,9,16/12/2020,NULL
253347,175666,4,28/03/2021,7822211,190319,93749,96571,7631892,N,NULL,9,16/12/2020,NULL
253348,175666,5,28/04/2021,7727290,190319,94921,95399,7536971,N,NULL,9,16/12/2020,NULL
253349,175666,6,28/05/2021,7631183,190319,96107,94212,7440864,N,NULL,9,16/12/2020,NULL
253350,175666,7,28/06/2021,7533874,190319,97309,93011,7343555,N,NULL,9,16/12/2020,NULL
253351,175666,8,28/07/2021,7435349,190319,98525,91794,7245030,N,NULL,9,16/12/2020,NULL
253352,175666,9,28/08/2021,7335592,190319,99757,90563,7145273,N,NULL,9,16/12/2020,NULL
253353,175666,10,28/09/2021,7234588,190319,101004,89316,7044269,N,NULL,9,16/12/2020,NULL
253354,175666,11,28/10/2021,7132322,190319,102266,88053,6942003,N,NULL,9,16/12/2020,NULL
253355,175666,12,28/11/2021,7028778,190319,103544,86775,6838459,N,NULL,9,16/12/2020,NULL
253356,175666,13,28/12/2021,6923939,190319,104839,85481,6733620,N,NULL,9,16/12/2020,NULL
253357,175666,14,28/01/2022,6817790,190319,106149,84170,6627471,N,NULL,9,16/12/2020,NULL
253358,175666,15,28/02/2022,6710314,190319,107476,82843,6519995,N,NULL,9,16/12/2020,NULL
253359,175666,16,28/03/2022,6601495,190319,108819,81500,6411176,N,NULL,9,16/12/2020,NULL
253360,175666,17,28/04/2022,6491315,190319,110180,80140,6300996,N,NULL,9,16/12/2020,NULL
253361,175666,18,28/05/2022,6379758,190319,111557,78762,6189439,N,NULL,9,16/12/2020,NULL
253362,175666,19,28/06/2022,6266807,190319,112951,77368,6076488,N,NULL,9,16/12/2020,NULL
253363,175666,20,28/07/2022,6152444,190319,114363,75956,5962125,N,NULL,9,16/12/2020,NULL
253364,175666,21,28/08/2022,6036651,190319,115793,74527,5846332,N,NULL,9,16/12/2020,NULL
253365,175666,22,28/09/2022,5919411,190319,117240,73079,5729092,N,NULL,9,16/12/2020,NULL
253366,175666,23,28/10/2022,5800705,190319,118706,71614,5610386,N,NULL,9,16/12/2020,NULL
253367,175666,24,28/11/2022,5680515,190319,120190,70130,5490196,N,NULL,9,16/12/2020,NULL
253368,175666,25,28/12/2022,5558823,190319,121692,68627,5368504,N,NULL,9,16/12/2020,NULL
253369,175666,26,28/01/2023,5435610,190319,123213,67106,5245291,N,NULL,9,16/12/2020,NULL
253370,175666,27,28/02/2023,5310857,190319,124753,65566,5120538,N,NULL,9,16/12/2020,NULL
253371,175666,28,28/03/2023,5184544,190319,126313,64007,4994225,N,NULL,9,16/12/2020,NULL
253372,175666,29,28/04/2023,5056652,190319,127892,62428,4866333,N,NULL,9,16/12/2020,NULL
253373,175666,30,28/05/2023,4927162,190319,129490,60829,4736843,N,NULL,9,16/12/2020,NULL
253374,175666,31,28/06/2023,4796053,190319,131109,59211,4605734,N,NULL,9,16/12/2020,NULL
253375,175666,32,28/07/2023,4663305,190319,132748,57572,4472986,N,NULL,9,16/12/2020,NULL
253376,175666,33,28/08/2023,4528898,190319,134407,55912,4338579,N,NULL,9,16/12/2020,NULL
253377,175666,34,28/09/2023,4392811,190319,136087,54232,4202492,N,NULL,9,16/12/2020,NULL
253378,175666,35,28/10/2023,4255023,190319,137788,52531,4064704,N,NULL,9,16/12/2020,NULL
253379,175666,36,28/11/2023,4115512,190319,139511,50809,3925193,N,NULL,9,16/12/2020,NULL
253380,175666,37,28/12/2023,3974257,190319,141255,49065,3783938,N,NULL,9,16/12/2020,NULL
253381,175666,38,28/01/2024,3831237,190319,143020,47299,3640918,N,NULL,9,16/12/2020,NULL
253382,175666,39,28/02/2024,3686429,190319,144808,45511,3496110,N,NULL,9,16/12/2020,NULL
253383,175666,40,28/03/2024,3539811,190319,146618,43701,3349492,N,NULL,9,16/12/2020,NULL
253384,175666,41,28/04/2024,3391360,190319,148451,41869,3201041,N,NULL,9,16/12/2020,NULL
253385,175666,42,28/05/2024,3241054,190319,150306,40013,3050735,N,NULL,9,16/12/2020,NULL
253386,175666,43,28/06/2024,3088869,190319,152185,38134,2898550,N,NULL,9,16/12/2020,NULL
253387,175666,44,28/07/2024,2934781,190319,154088,36232,2744462,N,NULL,9,16/12/2020,NULL
253388,175666,45,28/08/2024,2778767,190319,156014,34306,2588448,N,NULL,9,16/12/2020,NULL
253389,175666,46,28/09/2024,2620803,190319,157964,32356,2430484,N,NULL,9,16/12/2020,NULL
253390,175666,47,28/10/2024,2460865,190319,159938,30381,2270546,N,NULL,9,16/12/2020,NULL
253391,175666,48,28/11/2024,2298927,190319,161938,28382,2108608,N,NULL,9,16/12/2020,NULL
253392,175666,49,28/12/2024,2134965,190319,163962,26358,1944646,N,NULL,9,16/12/2020,NULL
253393,175666,50,28/01/2025,1968954,190319,166011,24308,1778635,N,NULL,9,16/12/2020,NULL
253394,175666,51,28/02/2025,1800868,190319,168086,22233,1610549,N,NULL,9,16/12/2020,NULL
253395,175666,52,28/03/2025,1630680,190319,170188,20132,1440361,N,NULL,9,16/12/2020,NULL
253396,175666,53,28/04/2025,1458365,190319,172315,18005,1268046,N,NULL,9,16/12/2020,NULL
253397,175666,54,28/05/2025,1283896,190319,174469,15851,1093577,N,NULL,9,16/12/2020,NULL
253398,175666,55,28/06/2025,1107246,190319,176650,13670,916927,N,NULL,9,16/12/2020,NULL
253399,175666,56,28/07/2025,928388,190319,178858,11462,738069,N,NULL,9,16/12/2020,NULL
253400,175666,57,28/08/2025,747294,190319,181094,9226,556975,N,NULL,9,16/12/2020,NULL
253401,175666,58,28/09/2025,563937,190319,183357,6962,373618,N,NULL,9,16/12/2020,NULL
253402,175666,59,28/10/2025,378288,190319,185649,4670,187969,N,NULL,9,16/12/2020,NULL
253403,175666,60,28/11/2025,190318,190319,187969,2350,0,N,NULL,9,16/12/2020,NULL
253404,175667,1,30/12/2020,16200000,380639,180639,200000,15819361,N,NULL,9,16/12/2020,NULL
253405,175667,2,30/01/2021,16017103,380639,182897,197742,15636464,N,NULL,9,16/12/2020,NULL
253406,175667,3,28/02/2021,15831920,380639,185183,195456,15451281,N,NULL,9,16/12/2020,NULL
253407,175667,4,28/03/2021,15644422,380639,187498,193141,15263783,N,NULL,9,16/12/2020,NULL
253408,175667,5,28/04/2021,15454580,380639,189842,190797,15073941,N,NULL,9,16/12/2020,NULL
253409,175667,6,28/05/2021,15262365,380639,192215,188424,14881726,N,NULL,9,16/12/2020,NULL
253410,175667,7,28/06/2021,15067748,380639,194617,186022,14687109,N,NULL,9,16/12/2020,NULL
253411,175667,8,28/07/2021,14870698,380639,197050,183589,14490059,N,NULL,9,16/12/2020,NULL
253412,175667,9,28/08/2021,14671185,380639,199513,181126,14290546,N,NULL,9,16/12/2020,NULL
253413,175667,10,28/09/2021,14469178,380639,202007,178632,14088539,N,NULL,9,16/12/2020,NULL
253414,175667,11,28/10/2021,14264646,380639,204532,176107,13884007,N,NULL,9,16/12/2020,NULL
253415,175667,12,28/11/2021,14057557,380639,207089,173550,13676918,N,NULL,9,16/12/2020,NULL
253416,175667,13,28/12/2021,13847880,380639,209677,170961,13467241,N,NULL,9,16/12/2020,NULL
253417,175667,14,28/01/2022,13635582,380639,212298,168341,13254943,N,NULL,9,16/12/2020,NULL
253418,175667,15,28/02/2022,13420630,380639,214952,165687,13039991,N,NULL,9,16/12/2020,NULL
253419,175667,16,28/03/2022,13202991,380639,217639,163000,12822352,N,NULL,9,16/12/2020,NULL
253420,175667,17,28/04/2022,12982632,380639,220359,160279,12601993,N,NULL,9,16/12/2020,NULL
253421,175667,18,28/05/2022,12759518,380639,223114,157525,12378879,N,NULL,9,16/12/2020,NULL
253422,175667,19,28/06/2022,12533615,380639,225903,154736,12152976,N,NULL,9,16/12/2020,NULL
253423,175667,20,28/07/2022,12304888,380639,228727,151912,11924249,N,NULL,9,16/12/2020,NULL
253424,175667,21,28/08/2022,12073302,380639,231586,149053,11692663,N,NULL,9,16/12/2020,NULL
253425,175667,22,28/09/2022,11838821,380639,234481,146158,11458182,N,NULL,9,16/12/2020,NULL
253426,175667,23,28/10/2022,11601409,380639,237412,143227,11220770,N,NULL,9,16/12/2020,NULL
253427,175667,24,28/11/2022,11361030,380639,240379,140260,10980391,N,NULL,9,16/12/2020,NULL
253428,175667,25,28/12/2022,11117646,380639,243384,137255,10737007,N,NULL,9,16/12/2020,NULL
253429,175667,26,28/01/2023,10871220,380639,246426,134213,10490581,N,NULL,9,16/12/2020,NULL
253430,175667,27,28/02/2023,10621713,380639,249507,131132,10241074,N,NULL,9,16/12/2020,NULL
253431,175667,28,28/03/2023,10369088,380639,252625,128013,9988449,N,NULL,9,16/12/2020,NULL
253432,175667,29,28/04/2023,10113305,380639,255783,124856,9732666,N,NULL,9,16/12/2020,NULL
253433,175667,30,28/05/2023,9854324,380639,258981,121658,9473685,N,NULL,9,16/12/2020,NULL
253434,175667,31,28/06/2023,9592106,380639,262218,118421,9211467,N,NULL,9,16/12/2020,NULL
253435,175667,32,28/07/2023,9326610,380639,265496,115143,8945971,N,NULL,9,16/12/2020,NULL
253436,175667,33,28/08/2023,9057796,380639,268814,111825,8677157,N,NULL,9,16/12/2020,NULL
253437,175667,34,28/09/2023,8785622,380639,272174,108464,8404983,N,NULL,9,16/12/2020,NULL
253438,175667,35,28/10/2023,8510045,380639,275577,105062,8129406,N,NULL,9,16/12/2020,NULL
253439,175667,36,28/11/2023,8231024,380639,279021,101618,7850385,N,NULL,9,16/12/2020,NULL
253440,175667,37,28/12/2023,7948515,380639,282509,98130,7567876,N,NULL,9,16/12/2020,NULL
253441,175667,38,28/01/2024,7662475,380639,286040,94598,7281836,N,NULL,9,16/12/2020,NULL
253442,175667,39,28/02/2024,7372859,380639,289616,91023,6992220,N,NULL,9,16/12/2020,NULL
253443,175667,40,28/03/2024,7079623,380639,293236,87403,6698984,N,NULL,9,16/12/2020,NULL
253444,175667,41,28/04/2024,6782721,380639,296902,83737,6402082,N,NULL,9,16/12/2020,NULL
253445,175667,42,28/05/2024,6482108,380639,300613,80026,6101469,N,NULL,9,16/12/2020,NULL
253446,175667,43,28/06/2024,6177737,380639,304371,76268,5797098,N,NULL,9,16/12/2020,NULL
253447,175667,44,28/07/2024,5869562,380639,308175,72464,5488923,N,NULL,9,16/12/2020,NULL
253448,175667,45,28/08/2024,5557535,380639,312027,68612,5176896,N,NULL,9,16/12/2020,NULL
253449,175667,46,28/09/2024,5241607,380639,315928,64711,4860968,N,NULL,9,16/12/2020,NULL
253450,175667,47,28/10/2024,4921730,380639,319877,60762,4541091,N,NULL,9,16/12/2020,NULL
253451,175667,48,28/11/2024,4597855,380639,323875,56764,4217216,N,NULL,9,16/12/2020,NULL
253452,175667,49,28/12/2024,4269931,380639,327924,52715,3889292,N,NULL,9,16/12/2020,NULL
253453,175667,50,28/01/2025,3937908,380639,332023,48616,3557269,N,NULL,9,16/12/2020,NULL
253454,175667,51,28/02/2025,3601735,380639,336173,44466,3221096,N,NULL,9,16/12/2020,NULL
253455,175667,52,28/03/2025,3261360,380639,340375,40264,2880721,N,NULL,9,16/12/2020,NULL
253456,175667,53,28/04/2025,2916730,380639,344630,36009,2536091,N,NULL,9,16/12/2020,NULL
253457,175667,54,28/05/2025,2567792,380639,348938,31701,2187153,N,NULL,9,16/12/2020,NULL
253458,175667,55,28/06/2025,2214493,380639,353299,27339,1833854,N,NULL,9,16/12/2020,NULL
253459,175667,56,28/07/2025,1856777,380639,357716,22923,1476138,N,NULL,9,16/12/2020,NULL
253460,175667,57,28/08/2025,1494590,380639,362187,18452,1113951,N,NULL,9,16/12/2020,NULL
253461,175667,58,28/09/2025,1127876,380639,366714,13924,747237,N,NULL,9,16/12/2020,NULL
253462,175667,59,28/10/2025,756578,380639,371298,9340,375939,N,NULL,9,16/12/2020,NULL
253463,175667,60,28/11/2025,380638,380639,375939,4699,0,N,NULL,9,16/12/2020,NULL
253464,175668,1,30/12/2020,24300000,570958,270958,300000,23729042,N,NULL,9,16/12/2020,NULL
253465,175668,2,30/01/2021,24025655,570958,274345,296613,23454697,N,NULL,9,16/12/2020,NULL
253466,175668,3,28/02/2021,23747880,570958,277775,293184,23176922,N,NULL,9,16/12/2020,NULL
253467,175668,4,28/03/2021,23466633,570958,281247,289712,22895675,N,NULL,9,16/12/2020,NULL
253468,175668,5,28/04/2021,23181871,570958,284762,286196,22610913,N,NULL,9,16/12/2020,NULL
253469,175668,6,28/05/2021,22893549,570958,288322,282636,22322591,N,NULL,9,16/12/2020,NULL
253470,175668,7,28/06/2021,22601623,570958,291926,279032,22030665,N,NULL,9,16/12/2020,NULL
253471,175668,8,28/07/2021,22306048,570958,295575,275383,21735090,N,NULL,9,16/12/2020,NULL
253472,175668,9,28/08/2021,22006778,570958,299270,271689,21435820,N,NULL,9,16/12/2020,NULL
253473,175668,10,28/09/2021,21703767,570958,303011,267948,21132809,N,NULL,9,16/12/2020,NULL
253474,175668,11,28/10/2021,21396969,570958,306798,264160,20826011,N,NULL,9,16/12/2020,NULL
253475,175668,12,28/11/2021,21086336,570958,310633,260325,20515378,N,NULL,9,16/12/2020,NULL
253476,175668,13,28/12/2021,20771820,570958,314516,256442,20200862,N,NULL,9,16/12/2020,NULL
253477,175668,14,28/01/2022,20453372,570958,318448,252511,19882414,N,NULL,9,16/12/2020,NULL
253478,175668,15,28/02/2022,20130944,570958,322428,248530,19559986,N,NULL,9,16/12/2020,NULL
253479,175668,16,28/03/2022,19804486,570958,326458,244500,19233528,N,NULL,9,16/12/2020,NULL
253480,175668,17,28/04/2022,19473947,570958,330539,240419,18902989,N,NULL,9,16/12/2020,NULL
253481,175668,18,28/05/2022,19139276,570958,334671,236287,18568318,N,NULL,9,16/12/2020,NULL
253482,175668,19,28/06/2022,18800422,570958,338854,232104,18229464,N,NULL,9,16/12/2020,NULL
253483,175668,20,28/07/2022,18457332,570958,343090,227868,17886374,N,NULL,9,16/12/2020,NULL
253484,175668,21,28/08/2022,18109953,570958,347379,223580,17538995,N,NULL,9,16/12/2020,NULL
253485,175668,22,28/09/2022,17758232,570958,351721,219237,17187274,N,NULL,9,16/12/2020,NULL
253486,175668,23,28/10/2022,17402115,570958,356117,214841,16831157,N,NULL,9,16/12/2020,NULL
253487,175668,24,28/11/2022,17041546,570958,360569,210389,16470588,N,NULL,9,16/12/2020,NULL
253488,175668,25,28/12/2022,16676470,570958,365076,205882,16105512,N,NULL,9,16/12/2020,NULL
253489,175668,26,28/01/2023,16306831,570958,369639,201319,15735873,N,NULL,9,16/12/2020,NULL
253490,175668,27,28/02/2023,15932571,570958,374260,196698,15361613,N,NULL,9,16/12/2020,NULL
253491,175668,28,28/03/2023,15553633,570958,378938,192020,14982675,N,NULL,9,16/12/2020,NULL
253492,175668,29,28/04/2023,15169958,570958,383675,187283,14599000,N,NULL,9,16/12/2020,NULL
253493,175668,30,28/05/2023,14781487,570958,388471,182487,14210529,N,NULL,9,16/12/2020,NULL
253494,175668,31,28/06/2023,14388160,570958,393327,177632,13817202,N,NULL,9,16/12/2020,NULL
253495,175668,32,28/07/2023,13989917,570958,398243,172715,13418959,N,NULL,9,16/12/2020,NULL
253496,175668,33,28/08/2023,13586696,570958,403221,167737,13015738,N,NULL,9,16/12/2020,NULL
253497,175668,34,28/09/2023,13178434,570958,408262,162697,12607476,N,NULL,9,16/12/2020,NULL
253498,175668,35,28/10/2023,12765069,570958,413365,157593,12194111,N,NULL,9,16/12/2020,NULL
253499,175668,36,28/11/2023,12346537,570958,418532,152426,11775579,N,NULL,9,16/12/2020,NULL
253500,175668,37,28/12/2023,11922773,570958,423764,147195,11351815,N,NULL,9,16/12/2020,NULL
253501,175668,38,28/01/2024,11493712,570958,429061,141898,10922754,N,NULL,9,16/12/2020,NULL
253502,175668,39,28/02/2024,11059288,570958,434424,136534,10488330,N,NULL,9,16/12/2020,NULL
253503,175668,40,28/03/2024,10619434,570958,439854,131104,10048476,N,NULL,9,16/12/2020,NULL
253504,175668,41,28/04/2024,10174082,570958,445352,125606,9603124,N,NULL,9,16/12/2020,NULL
253505,175668,42,28/05/2024,9723163,570958,450919,120039,9152205,N,NULL,9,16/12/2020,NULL
253506,175668,43,28/06/2024,9266607,570958,456556,114403,8695649,N,NULL,9,16/12/2020,NULL
253507,175668,44,28/07/2024,8804344,570958,462263,108696,8233386,N,NULL,9,16/12/2020,NULL
253508,175668,45,28/08/2024,8336303,570958,468041,102917,7765345,N,NULL,9,16/12/2020,NULL
253509,175668,46,28/09/2024,7862411,570958,473892,97067,7291453,N,NULL,9,16/12/2020,NULL
253510,175668,47,28/10/2024,7382596,570958,479815,91143,6811638,N,NULL,9,16/12/2020,NULL
253511,175668,48,28/11/2024,6896783,570958,485813,85145,6325825,N,NULL,9,16/12/2020,NULL
253512,175668,49,28/12/2024,6404897,570958,491886,79073,5833939,N,NULL,9,16/12/2020,NULL
253513,175668,50,28/01/2025,5906863,570958,498034,72924,5335905,N,NULL,9,16/12/2020,NULL
253514,175668,51,28/02/2025,5402604,570958,504259,66699,4831646,N,NULL,9,16/12/2020,NULL
253515,175668,52,28/03/2025,4892041,570958,510563,60396,4321083,N,NULL,9,16/12/2020,NULL
253516,175668,53,28/04/2025,4375096,570958,516945,54014,3804138,N,NULL,9,16/12/2020,NULL
253517,175668,54,28/05/2025,3851689,570958,523407,47552,3280731,N,NULL,9,16/12/2020,NULL
253518,175668,55,28/06/2025,3321740,570958,529949,41009,2750782,N,NULL,9,16/12/2020,NULL
253519,175668,56,28/07/2025,2785166,570958,536574,34385,2214208,N,NULL,9,16/12/2020,NULL
253520,175668,57,28/08/2025,2241885,570958,543281,27678,1670927,N,NULL,9,16/12/2020,NULL
253521,175668,58,28/09/2025,1691813,570958,550072,20887,1120855,N,NULL,9,16/12/2020,NULL
253522,175668,59,28/10/2025,1134865,570958,556948,14011,563907,N,NULL,9,16/12/2020,NULL
253523,175668,60,28/11/2025,570956,570958,563907,7049,0,N,NULL,9,16/12/2020,NULL
253524,175669,1,30/12/2020,40500000,951597,451597,500000,39548403,N,NULL,9,16/12/2020,NULL
253525,175669,2,30/01/2021,40042758,951597,457242,494355,39091161,N,NULL,9,16/12/2020,NULL
253526,175669,3,28/02/2021,39579800,951597,462958,488640,38628203,N,NULL,9,16/12/2020,NULL
253527,175669,4,28/03/2021,39111055,951597,468745,482853,38159458,N,NULL,9,16/12/2020,NULL
253528,175669,5,28/04/2021,38636451,951597,474604,476993,37684854,N,NULL,9,16/12/2020,NULL
253529,175669,6,28/05/2021,38155914,951597,480537,471061,37204317,N,NULL,9,16/12/2020,NULL
253530,175669,7,28/06/2021,37669371,951597,486543,465054,36717774,N,NULL,9,16/12/2020,NULL
253531,175669,8,28/07/2021,37176746,951597,492625,458972,36225149,N,NULL,9,16/12/2020,NULL
253532,175669,9,28/08/2021,36677963,951597,498783,452814,35726366,N,NULL,9,16/12/2020,NULL
253533,175669,10,28/09/2021,36172945,951597,505018,446580,35221348,N,NULL,9,16/12/2020,NULL
253534,175669,11,28/10/2021,35661615,951597,511330,440267,34710018,N,NULL,9,16/12/2020,NULL
253535,175669,12,28/11/2021,35143893,951597,517722,433875,34192296,N,NULL,9,16/12/2020,NULL
253536,175669,13,28/12/2021,34619700,951597,524193,427404,33668103,N,NULL,9,16/12/2020,NULL
253537,175669,14,28/01/2022,34088954,951597,530746,420851,33137357,N,NULL,9,16/12/2020,NULL
253538,175669,15,28/02/2022,33551574,951597,537380,414217,32599977,N,NULL,9,16/12/2020,NULL
253539,175669,16,28/03/2022,33007477,951597,544097,407500,32055880,N,NULL,9,16/12/2020,NULL
253540,175669,17,28/04/2022,32456578,951597,550899,400698,31504981,N,NULL,9,16/12/2020,NULL
253541,175669,18,28/05/2022,31898793,951597,557785,393812,30947196,N,NULL,9,16/12/2020,NULL
253542,175669,19,28/06/2022,31334036,951597,564757,386840,30382439,N,NULL,9,16/12/2020,NULL
253543,175669,20,28/07/2022,30762219,951597,571817,379780,29810622,N,NULL,9,16/12/2020,NULL
253544,175669,21,28/08/2022,30183255,951597,578964,372633,29231658,N,NULL,9,16/12/2020,NULL
253545,175669,22,28/09/2022,29597054,951597,586201,365396,28645457,N,NULL,9,16/12/2020,NULL
253546,175669,23,28/10/2022,29003525,951597,593529,358068,28051928,N,NULL,9,16/12/2020,NULL
253547,175669,24,28/11/2022,28402577,951597,600948,350649,27450980,N,NULL,9,16/12/2020,NULL
253548,175669,25,28/12/2022,27794117,951597,608460,343137,26842520,N,NULL,9,16/12/2020,NULL
253549,175669,26,28/01/2023,27178051,951597,616066,335531,26226454,N,NULL,9,16/12/2020,NULL
253550,175669,27,28/02/2023,26554284,951597,623767,327831,25602687,N,NULL,9,16/12/2020,NULL
253551,175669,28,28/03/2023,25922720,951597,631564,320034,24971123,N,NULL,9,16/12/2020,NULL
253552,175669,29,28/04/2023,25283262,951597,639458,312139,24331665,N,NULL,9,16/12/2020,NULL
253553,175669,30,28/05/2023,24635811,951597,647451,304146,23684214,N,NULL,9,16/12/2020,NULL
253554,175669,31,28/06/2023,23980266,951597,655545,296053,23028669,N,NULL,9,16/12/2020,NULL
253555,175669,32,28/07/2023,23316527,951597,663739,287858,22364930,N,NULL,9,16/12/2020,NULL
253556,175669,33,28/08/2023,22644491,951597,672036,279562,21692894,N,NULL,9,16/12/2020,NULL
253557,175669,34,28/09/2023,21964055,951597,680436,271161,21012458,N,NULL,9,16/12/2020,NULL
253558,175669,35,28/10/2023,21275114,951597,688941,262656,20323517,N,NULL,9,16/12/2020,NULL
253559,175669,36,28/11/2023,20577561,951597,697553,254044,19625964,N,NULL,9,16/12/2020,NULL
253560,175669,37,28/12/2023,19871288,951597,706273,245325,18919691,N,NULL,9,16/12/2020,NULL
253561,175669,38,28/01/2024,19156187,951597,715101,236496,18204590,N,NULL,9,16/12/2020,NULL
253562,175669,39,28/02/2024,18432147,951597,724040,227557,17480550,N,NULL,9,16/12/2020,NULL
253563,175669,40,28/03/2024,17699057,951597,733090,218507,16747460,N,NULL,9,16/12/2020,NULL
253564,175669,41,28/04/2024,16956803,951597,742254,209343,16005206,N,NULL,9,16/12/2020,NULL
253565,175669,42,28/05/2024,16205271,951597,751532,200065,15253674,N,NULL,9,16/12/2020,NULL
253566,175669,43,28/06/2024,15444345,951597,760926,190671,14492748,N,NULL,9,16/12/2020,NULL
253567,175669,44,28/07/2024,14673907,951597,770438,181159,13722310,N,NULL,9,16/12/2020,NULL
253568,175669,45,28/08/2024,13893839,951597,780068,171529,12942242,N,NULL,9,16/12/2020,NULL
253569,175669,46,28/09/2024,13104020,951597,789819,161778,12152423,N,NULL,9,16/12/2020,NULL
253570,175669,47,28/10/2024,12304328,951597,799692,151905,11352731,N,NULL,9,16/12/2020,NULL
253571,175669,48,28/11/2024,11494640,951597,809688,141909,10543043,N,NULL,9,16/12/2020,NULL
253572,175669,49,28/12/2024,10674831,951597,819809,131788,9723234,N,NULL,9,16/12/2020,NULL
253573,175669,50,28/01/2025,9844774,951597,830057,121540,8893177,N,NULL,9,16/12/2020,NULL
253574,175669,51,28/02/2025,9004342,951597,840432,111165,8052745,N,NULL,9,16/12/2020,NULL
253575,175669,52,28/03/2025,8153404,951597,850938,100659,7201807,N,NULL,9,16/12/2020,NULL
253576,175669,53,28/04/2025,7291829,951597,861575,90023,6340232,N,NULL,9,16/12/2020,NULL
253577,175669,54,28/05/2025,6419485,951597,872344,79253,5467888,N,NULL,9,16/12/2020,NULL
253578,175669,55,28/06/2025,5536236,951597,883249,68349,4584639,N,NULL,9,16/12/2020,NULL
253579,175669,56,28/07/2025,4641947,951597,894289,57308,3690350,N,NULL,9,16/12/2020,NULL
253580,175669,57,28/08/2025,3736479,951597,905468,46129,2784882,N,NULL,9,16/12/2020,NULL
253581,175669,58,28/09/2025,2819693,951597,916786,34811,1868096,N,NULL,9,16/12/2020,NULL
253582,175669,59,28/10/2025,1891447,951597,928246,23351,939850,N,NULL,9,16/12/2020,NULL
253583,175669,60,28/11/2025,951598,951597,939850,11748,0,N,NULL,9,16/12/2020,NULL
253584,175670,1,30/12/2020,16200000,1444133,1244133,200000,14755867,N,NULL,9,16/12/2020,NULL
253585,175670,2,30/01/2021,14940315,1444133,1259685,184448,13496182,N,NULL,9,16/12/2020,NULL
253586,175670,3,28/02/2021,13664884,1444133,1275431,168702,12220751,N,NULL,9,16/12/2020,NULL
253587,175670,4,28/03/2021,12373510,1444133,1291374,152759,10929377,N,NULL,9,16/12/2020,NULL
253588,175670,5,28/04/2021,11065994,1444133,1307516,136617,9621861,N,NULL,9,16/12/2020,NULL
253589,175670,6,28/05/2021,9742134,1444133,1323860,120273,8298001,N,NULL,9,16/12/2020,NULL
253590,175670,7,28/06/2021,8401726,1444133,1340408,103725,6957593,N,NULL,9,16/12/2020,NULL
253591,175670,8,28/07/2021,7044563,1444133,1357163,86970,5600430,N,NULL,9,16/12/2020,NULL
253592,175670,9,28/08/2021,5670435,1444133,1374128,70005,4226302,N,NULL,9,16/12/2020,NULL
253593,175670,10,28/09/2021,4279131,1444133,1391304,52829,2834998,N,NULL,9,16/12/2020,NULL
253594,175670,11,28/10/2021,2870435,1444133,1408696,35437,1426302,N,NULL,9,16/12/2020,NULL
253595,175670,12,28/11/2021,1444131,1444133,1426302,17829,0,N,NULL,9,16/12/2020,NULL
253596,175671,1,30/12/2020,8100000,190319,90319,100000,7909681,N,NULL,9,16/12/2020,NULL
253597,175671,2,30/01/2021,8008552,190319,91448,98871,7818233,N,NULL,9,16/12/2020,NULL
253598,175671,3,28/02/2021,7915960,190319,92592,97728,7725641,N,NULL,9,16/12/2020,NULL
253599,175671,4,28/03/2021,7822211,190319,93749,96571,7631892,N,NULL,9,16/12/2020,NULL
253600,175671,5,28/04/2021,7727290,190319,94921,95399,7536971,N,NULL,9,16/12/2020,NULL
253601,175671,6,28/05/2021,7631183,190319,96107,94212,7440864,N,NULL,9,16/12/2020,NULL
253602,175671,7,28/06/2021,7533874,190319,97309,93011,7343555,N,NULL,9,16/12/2020,NULL
253603,175671,8,28/07/2021,7435349,190319,98525,91794,7245030,N,NULL,9,16/12/2020,NULL
253604,175671,9,28/08/2021,7335592,190319,99757,90563,7145273,N,NULL,9,16/12/2020,NULL
253605,175671,10,28/09/2021,7234588,190319,101004,89316,7044269,N,NULL,9,16/12/2020,NULL
253606,175671,11,28/10/2021,7132322,190319,102266,88053,6942003,N,NULL,9,16/12/2020,NULL
253607,175671,12,28/11/2021,7028778,190319,103544,86775,6838459,N,NULL,9,16/12/2020,NULL
253608,175671,13,28/12/2021,6923939,190319,104839,85481,6733620,N,NULL,9,16/12/2020,NULL
253609,175671,14,28/01/2022,6817790,190319,106149,84170,6627471,N,NULL,9,16/12/2020,NULL
253610,175671,15,28/02/2022,6710314,190319,107476,82843,6519995,N,NULL,9,16/12/2020,NULL
253611,175671,16,28/03/2022,6601495,190319,108819,81500,6411176,N,NULL,9,16/12/2020,NULL
253612,175671,17,28/04/2022,6491315,190319,110180,80140,6300996,N,NULL,9,16/12/2020,NULL
253613,175671,18,28/05/2022,6379758,190319,111557,78762,6189439,N,NULL,9,16/12/2020,NULL
253614,175671,19,28/06/2022,6266807,190319,112951,77368,6076488,N,NULL,9,16/12/2020,NULL
253615,175671,20,28/07/2022,6152444,190319,114363,75956,5962125,N,NULL,9,16/12/2020,NULL
253616,175671,21,28/08/2022,6036651,190319,115793,74527,5846332,N,NULL,9,16/12/2020,NULL
253617,175671,22,28/09/2022,5919411,190319,117240,73079,5729092,N,NULL,9,16/12/2020,NULL
253618,175671,23,28/10/2022,5800705,190319,118706,71614,5610386,N,NULL,9,16/12/2020,NULL
253619,175671,24,28/11/2022,5680515,190319,120190,70130,5490196,N,NULL,9,16/12/2020,NULL
253620,175671,25,28/12/2022,5558823,190319,121692,68627,5368504,N,NULL,9,16/12/2020,NULL
253621,175671,26,28/01/2023,5435610,190319,123213,67106,5245291,N,NULL,9,16/12/2020,NULL
253622,175671,27,28/02/2023,5310857,190319,124753,65566,5120538,N,NULL,9,16/12/2020,NULL
253623,175671,28,28/03/2023,5184544,190319,126313,64007,4994225,N,NULL,9,16/12/2020,NULL
253624,175671,29,28/04/2023,5056652,190319,127892,62428,4866333,N,NULL,9,16/12/2020,NULL
253625,175671,30,28/05/2023,4927162,190319,129490,60829,4736843,N,NULL,9,16/12/2020,NULL
253626,175671,31,28/06/2023,4796053,190319,131109,59211,4605734,N,NULL,9,16/12/2020,NULL
253627,175671,32,28/07/2023,4663305,190319,132748,57572,4472986,N,NULL,9,16/12/2020,NULL
253628,175671,33,28/08/2023,4528898,190319,134407,55912,4338579,N,NULL,9,16/12/2020,NULL
253629,175671,34,28/09/2023,4392811,190319,136087,54232,4202492,N,NULL,9,16/12/2020,NULL
253630,175671,35,28/10/2023,4255023,190319,137788,52531,4064704,N,NULL,9,16/12/2020,NULL
253631,175671,36,28/11/2023,4115512,190319,139511,50809,3925193,N,NULL,9,16/12/2020,NULL
253632,175671,37,28/12/2023,3974257,190319,141255,49065,3783938,N,NULL,9,16/12/2020,NULL
253633,175671,38,28/01/2024,3831237,190319,143020,47299,3640918,N,NULL,9,16/12/2020,NULL
253634,175671,39,28/02/2024,3686429,190319,144808,45511,3496110,N,NULL,9,16/12/2020,NULL
253635,175671,40,28/03/2024,3539811,190319,146618,43701,3349492,N,NULL,9,16/12/2020,NULL
253636,175671,41,28/04/2024,3391360,190319,148451,41869,3201041,N,NULL,9,16/12/2020,NULL
253637,175671,42,28/05/2024,3241054,190319,150306,40013,3050735,N,NULL,9,16/12/2020,NULL
253638,175671,43,28/06/2024,3088869,190319,152185,38134,2898550,N,NULL,9,16/12/2020,NULL
253639,175671,44,28/07/2024,2934781,190319,154088,36232,2744462,N,NULL,9,16/12/2020,NULL
253640,175671,45,28/08/2024,2778767,190319,156014,34306,2588448,N,NULL,9,16/12/2020,NULL
253641,175671,46,28/09/2024,2620803,190319,157964,32356,2430484,N,NULL,9,16/12/2020,NULL
253642,175671,47,28/10/2024,2460865,190319,159938,30381,2270546,N,NULL,9,16/12/2020,NULL
253643,175671,48,28/11/2024,2298927,190319,161938,28382,2108608,N,NULL,9,16/12/2020,NULL
253644,175671,49,28/12/2024,2134965,190319,163962,26358,1944646,N,NULL,9,16/12/2020,NULL
253645,175671,50,28/01/2025,1968954,190319,166011,24308,1778635,N,NULL,9,16/12/2020,NULL
253646,175671,51,28/02/2025,1800868,190319,168086,22233,1610549,N,NULL,9,16/12/2020,NULL
253647,175671,52,28/03/2025,1630680,190319,170188,20132,1440361,N,NULL,9,16/12/2020,NULL
253648,175671,53,28/04/2025,1458365,190319,172315,18005,1268046,N,NULL,9,16/12/2020,NULL
253649,175671,54,28/05/2025,1283896,190319,174469,15851,1093577,N,NULL,9,16/12/2020,NULL
253650,175671,55,28/06/2025,1107246,190319,176650,13670,916927,N,NULL,9,16/12/2020,NULL
253651,175671,56,28/07/2025,928388,190319,178858,11462,738069,N,NULL,9,16/12/2020,NULL
253652,175671,57,28/08/2025,747294,190319,181094,9226,556975,N,NULL,9,16/12/2020,NULL
253653,175671,58,28/09/2025,563937,190319,183357,6962,373618,N,NULL,9,16/12/2020,NULL
253654,175671,59,28/10/2025,378288,190319,185649,4670,187969,N,NULL,9,16/12/2020,NULL
253655,175671,60,28/11/2025,190318,190319,187969,2350,0,N,NULL,9,16/12/2020,NULL
253656,175672,1,30/12/2020,16200000,380639,180639,200000,15819361,N,NULL,9,16/12/2020,NULL
253657,175672,2,30/01/2021,16017103,380639,182897,197742,15636464,N,NULL,9,16/12/2020,NULL
253658,175672,3,28/02/2021,15831920,380639,185183,195456,15451281,N,NULL,9,16/12/2020,NULL
253659,175672,4,28/03/2021,15644422,380639,187498,193141,15263783,N,NULL,9,16/12/2020,NULL
253660,175672,5,28/04/2021,15454580,380639,189842,190797,15073941,N,NULL,9,16/12/2020,NULL
253661,175672,6,28/05/2021,15262365,380639,192215,188424,14881726,N,NULL,9,16/12/2020,NULL
253662,175672,7,28/06/2021,15067748,380639,194617,186022,14687109,N,NULL,9,16/12/2020,NULL
253663,175672,8,28/07/2021,14870698,380639,197050,183589,14490059,N,NULL,9,16/12/2020,NULL
253664,175672,9,28/08/2021,14671185,380639,199513,181126,14290546,N,NULL,9,16/12/2020,NULL
253665,175672,10,28/09/2021,14469178,380639,202007,178632,14088539,N,NULL,9,16/12/2020,NULL
253666,175672,11,28/10/2021,14264646,380639,204532,176107,13884007,N,NULL,9,16/12/2020,NULL
253667,175672,12,28/11/2021,14057557,380639,207089,173550,13676918,N,NULL,9,16/12/2020,NULL
253668,175672,13,28/12/2021,13847880,380639,209677,170961,13467241,N,NULL,9,16/12/2020,NULL
253669,175672,14,28/01/2022,13635582,380639,212298,168341,13254943,N,NULL,9,16/12/2020,NULL
253670,175672,15,28/02/2022,13420630,380639,214952,165687,13039991,N,NULL,9,16/12/2020,NULL
253671,175672,16,28/03/2022,13202991,380639,217639,163000,12822352,N,NULL,9,16/12/2020,NULL
253672,175672,17,28/04/2022,12982632,380639,220359,160279,12601993,N,NULL,9,16/12/2020,NULL
253673,175672,18,28/05/2022,12759518,380639,223114,157525,12378879,N,NULL,9,16/12/2020,NULL
253674,175672,19,28/06/2022,12533615,380639,225903,154736,12152976,N,NULL,9,16/12/2020,NULL
253675,175672,20,28/07/2022,12304888,380639,228727,151912,11924249,N,NULL,9,16/12/2020,NULL
253676,175672,21,28/08/2022,12073302,380639,231586,149053,11692663,N,NULL,9,16/12/2020,NULL
253677,175672,22,28/09/2022,11838821,380639,234481,146158,11458182,N,NULL,9,16/12/2020,NULL
253678,175672,23,28/10/2022,11601409,380639,237412,143227,11220770,N,NULL,9,16/12/2020,NULL
253679,175672,24,28/11/2022,11361030,380639,240379,140260,10980391,N,NULL,9,16/12/2020,NULL
253680,175672,25,28/12/2022,11117646,380639,243384,137255,10737007,N,NULL,9,16/12/2020,NULL
253681,175672,26,28/01/2023,10871220,380639,246426,134213,10490581,N,NULL,9,16/12/2020,NULL
253682,175672,27,28/02/2023,10621713,380639,249507,131132,10241074,N,NULL,9,16/12/2020,NULL
253683,175672,28,28/03/2023,10369088,380639,252625,128013,9988449,N,NULL,9,16/12/2020,NULL
253684,175672,29,28/04/2023,10113305,380639,255783,124856,9732666,N,NULL,9,16/12/2020,NULL
253685,175672,30,28/05/2023,9854324,380639,258981,121658,9473685,N,NULL,9,16/12/2020,NULL
253686,175672,31,28/06/2023,9592106,380639,262218,118421,9211467,N,NULL,9,16/12/2020,NULL
253687,175672,32,28/07/2023,9326610,380639,265496,115143,8945971,N,NULL,9,16/12/2020,NULL
253688,175672,33,28/08/2023,9057796,380639,268814,111825,8677157,N,NULL,9,16/12/2020,NULL
253689,175672,34,28/09/2023,8785622,380639,272174,108464,8404983,N,NULL,9,16/12/2020,NULL
253690,175672,35,28/10/2023,8510045,380639,275577,105062,8129406,N,NULL,9,16/12/2020,NULL
253691,175672,36,28/11/2023,8231024,380639,279021,101618,7850385,N,NULL,9,16/12/2020,NULL
253692,175672,37,28/12/2023,7948515,380639,282509,98130,7567876,N,NULL,9,16/12/2020,NULL
253693,175672,38,28/01/2024,7662475,380639,286040,94598,7281836,N,NULL,9,16/12/2020,NULL
253694,175672,39,28/02/2024,7372859,380639,289616,91023,6992220,N,NULL,9,16/12/2020,NULL
253695,175672,40,28/03/2024,7079623,380639,293236,87403,6698984,N,NULL,9,16/12/2020,NULL
253696,175672,41,28/04/2024,6782721,380639,296902,83737,6402082,N,NULL,9,16/12/2020,NULL
253697,175672,42,28/05/2024,6482108,380639,300613,80026,6101469,N,NULL,9,16/12/2020,NULL
253698,175672,43,28/06/2024,6177737,380639,304371,76268,5797098,N,NULL,9,16/12/2020,NULL
253699,175672,44,28/07/2024,5869562,380639,308175,72464,5488923,N,NULL,9,16/12/2020,NULL
253700,175672,45,28/08/2024,5557535,380639,312027,68612,5176896,N,NULL,9,16/12/2020,NULL
253701,175672,46,28/09/2024,5241607,380639,315928,64711,4860968,N,NULL,9,16/12/2020,NULL
253702,175672,47,28/10/2024,4921730,380639,319877,60762,4541091,N,NULL,9,16/12/2020,NULL
253703,175672,48,28/11/2024,4597855,380639,323875,56764,4217216,N,NULL,9,16/12/2020,NULL
253704,175672,49,28/12/2024,4269931,380639,327924,52715,3889292,N,NULL,9,16/12/2020,NULL
253705,175672,50,28/01/2025,3937908,380639,332023,48616,3557269,N,NULL,9,16/12/2020,NULL
253706,175672,51,28/02/2025,3601735,380639,336173,44466,3221096,N,NULL,9,16/12/2020,NULL
253707,175672,52,28/03/2025,3261360,380639,340375,40264,2880721,N,NULL,9,16/12/2020,NULL
253708,175672,53,28/04/2025,2916730,380639,344630,36009,2536091,N,NULL,9,16/12/2020,NULL
253709,175672,54,28/05/2025,2567792,380639,348938,31701,2187153,N,NULL,9,16/12/2020,NULL
253710,175672,55,28/06/2025,2214493,380639,353299,27339,1833854,N,NULL,9,16/12/2020,NULL
253711,175672,56,28/07/2025,1856777,380639,357716,22923,1476138,N,NULL,9,16/12/2020,NULL
253712,175672,57,28/08/2025,1494590,380639,362187,18452,1113951,N,NULL,9,16/12/2020,NULL
253713,175672,58,28/09/2025,1127876,380639,366714,13924,747237,N,NULL,9,16/12/2020,NULL
253714,175672,59,28/10/2025,756578,380639,371298,9340,375939,N,NULL,9,16/12/2020,NULL
253715,175672,60,28/11/2025,380638,380639,375939,4699,0,N,NULL,9,16/12/2020,NULL
253716,175673,1,30/12/2020,16200000,380639,180639,200000,15819361,N,NULL,9,16/12/2020,NULL
253717,175673,2,30/01/2021,16017103,380639,182897,197742,15636464,N,NULL,9,16/12/2020,NULL
253718,175673,3,28/02/2021,15831920,380639,185183,195456,15451281,N,NULL,9,16/12/2020,NULL
253719,175673,4,28/03/2021,15644422,380639,187498,193141,15263783,N,NULL,9,16/12/2020,NULL
253720,175673,5,28/04/2021,15454580,380639,189842,190797,15073941,N,NULL,9,16/12/2020,NULL
253721,175673,6,28/05/2021,15262365,380639,192215,188424,14881726,N,NULL,9,16/12/2020,NULL
253722,175673,7,28/06/2021,15067748,380639,194617,186022,14687109,N,NULL,9,16/12/2020,NULL
253723,175673,8,28/07/2021,14870698,380639,197050,183589,14490059,N,NULL,9,16/12/2020,NULL
253724,175673,9,28/08/2021,14671185,380639,199513,181126,14290546,N,NULL,9,16/12/2020,NULL
253725,175673,10,28/09/2021,14469178,380639,202007,178632,14088539,N,NULL,9,16/12/2020,NULL
253726,175673,11,28/10/2021,14264646,380639,204532,176107,13884007,N,NULL,9,16/12/2020,NULL
253727,175673,12,28/11/2021,14057557,380639,207089,173550,13676918,N,NULL,9,16/12/2020,NULL
253728,175673,13,28/12/2021,13847880,380639,209677,170961,13467241,N,NULL,9,16/12/2020,NULL
253729,175673,14,28/01/2022,13635582,380639,212298,168341,13254943,N,NULL,9,16/12/2020,NULL
253730,175673,15,28/02/2022,13420630,380639,214952,165687,13039991,N,NULL,9,16/12/2020,NULL
253731,175673,16,28/03/2022,13202991,380639,217639,163000,12822352,N,NULL,9,16/12/2020,NULL
253732,175673,17,28/04/2022,12982632,380639,220359,160279,12601993,N,NULL,9,16/12/2020,NULL
253733,175673,18,28/05/2022,12759518,380639,223114,157525,12378879,N,NULL,9,16/12/2020,NULL
253734,175673,19,28/06/2022,12533615,380639,225903,154736,12152976,N,NULL,9,16/12/2020,NULL
253735,175673,20,28/07/2022,12304888,380639,228727,151912,11924249,N,NULL,9,16/12/2020,NULL
253736,175673,21,28/08/2022,12073302,380639,231586,149053,11692663,N,NULL,9,16/12/2020,NULL
253737,175673,22,28/09/2022,11838821,380639,234481,146158,11458182,N,NULL,9,16/12/2020,NULL
253738,175673,23,28/10/2022,11601409,380639,237412,143227,11220770,N,NULL,9,16/12/2020,NULL
253739,175673,24,28/11/2022,11361030,380639,240379,140260,10980391,N,NULL,9,16/12/2020,NULL
253740,175673,25,28/12/2022,11117646,380639,243384,137255,10737007,N,NULL,9,16/12/2020,NULL
253741,175673,26,28/01/2023,10871220,380639,246426,134213,10490581,N,NULL,9,16/12/2020,NULL
253742,175673,27,28/02/2023,10621713,380639,249507,131132,10241074,N,NULL,9,16/12/2020,NULL
253743,175673,28,28/03/2023,10369088,380639,252625,128013,9988449,N,NULL,9,16/12/2020,NULL
253744,175673,29,28/04/2023,10113305,380639,255783,124856,9732666,N,NULL,9,16/12/2020,NULL
253745,175673,30,28/05/2023,9854324,380639,258981,121658,9473685,N,NULL,9,16/12/2020,NULL
253746,175673,31,28/06/2023,9592106,380639,262218,118421,9211467,N,NULL,9,16/12/2020,NULL
253747,175673,32,28/07/2023,9326610,380639,265496,115143,8945971,N,NULL,9,16/12/2020,NULL
253748,175673,33,28/08/2023,9057796,380639,268814,111825,8677157,N,NULL,9,16/12/2020,NULL
253749,175673,34,28/09/2023,8785622,380639,272174,108464,8404983,N,NULL,9,16/12/2020,NULL
253750,175673,35,28/10/2023,8510045,380639,275577,105062,8129406,N,NULL,9,16/12/2020,NULL
253751,175673,36,28/11/2023,8231024,380639,279021,101618,7850385,N,NULL,9,16/12/2020,NULL
253752,175673,37,28/12/2023,7948515,380639,282509,98130,7567876,N,NULL,9,16/12/2020,NULL
253753,175673,38,28/01/2024,7662475,380639,286040,94598,7281836,N,NULL,9,16/12/2020,NULL
253754,175673,39,28/02/2024,7372859,380639,289616,91023,6992220,N,NULL,9,16/12/2020,NULL
253755,175673,40,28/03/2024,7079623,380639,293236,87403,6698984,N,NULL,9,16/12/2020,NULL
253756,175673,41,28/04/2024,6782721,380639,296902,83737,6402082,N,NULL,9,16/12/2020,NULL
253757,175673,42,28/05/2024,6482108,380639,300613,80026,6101469,N,NULL,9,16/12/2020,NULL
253758,175673,43,28/06/2024,6177737,380639,304371,76268,5797098,N,NULL,9,16/12/2020,NULL
253759,175673,44,28/07/2024,5869562,380639,308175,72464,5488923,N,NULL,9,16/12/2020,NULL
253760,175673,45,28/08/2024,5557535,380639,312027,68612,5176896,N,NULL,9,16/12/2020,NULL
253761,175673,46,28/09/2024,5241607,380639,315928,64711,4860968,N,NULL,9,16/12/2020,NULL
253762,175673,47,28/10/2024,4921730,380639,319877,60762,4541091,N,NULL,9,16/12/2020,NULL
253763,175673,48,28/11/2024,4597855,380639,323875,56764,4217216,N,NULL,9,16/12/2020,NULL
253764,175673,49,28/12/2024,4269931,380639,327924,52715,3889292,N,NULL,9,16/12/2020,NULL
253765,175673,50,28/01/2025,3937908,380639,332023,48616,3557269,N,NULL,9,16/12/2020,NULL
253766,175673,51,28/02/2025,3601735,380639,336173,44466,3221096,N,NULL,9,16/12/2020,NULL
253767,175673,52,28/03/2025,3261360,380639,340375,40264,2880721,N,NULL,9,16/12/2020,NULL
253768,175673,53,28/04/2025,2916730,380639,344630,36009,2536091,N,NULL,9,16/12/2020,NULL
253769,175673,54,28/05/2025,2567792,380639,348938,31701,2187153,N,NULL,9,16/12/2020,NULL
253770,175673,55,28/06/2025,2214493,380639,353299,27339,1833854,N,NULL,9,16/12/2020,NULL
253771,175673,56,28/07/2025,1856777,380639,357716,22923,1476138,N,NULL,9,16/12/2020,NULL
253772,175673,57,28/08/2025,1494590,380639,362187,18452,1113951,N,NULL,9,16/12/2020,NULL
253773,175673,58,28/09/2025,1127876,380639,366714,13924,747237,N,NULL,9,16/12/2020,NULL
253774,175673,59,28/10/2025,756578,380639,371298,9340,375939,N,NULL,9,16/12/2020,NULL
253775,175673,60,28/11/2025,380638,380639,375939,4699,0,N,NULL,9,16/12/2020,NULL
253776,175674,1,30/12/2020,16200000,775786,575786,200000,15424214,N,NULL,9,16/12/2020,NULL
253777,175674,2,30/01/2021,15617016,775786,582984,192803,14841230,N,NULL,9,16/12/2020,NULL
253778,175674,3,28/02/2021,15026745,775786,590271,185515,14250959,N,NULL,9,16/12/2020,NULL
253779,175674,4,28/03/2021,14429096,775786,597649,178137,13653310,N,NULL,9,16/12/2020,NULL
253780,175674,5,28/04/2021,13823976,775786,605120,170666,13048190,N,NULL,9,16/12/2020,NULL
253781,175674,6,28/05/2021,13211292,775786,612684,163102,12435506,N,NULL,9,16/12/2020,NULL
253782,175674,7,28/06/2021,12590949,775786,620343,155444,11815163,N,NULL,9,16/12/2020,NULL
253783,175674,8,28/07/2021,11962852,775786,628097,147690,11187066,N,NULL,9,16/12/2020,NULL
253784,175674,9,28/08/2021,11326904,775786,635948,139838,10551118,N,NULL,9,16/12/2020,NULL
253785,175674,10,28/09/2021,10683007,775786,643897,131889,9907221,N,NULL,9,16/12/2020,NULL
253786,175674,11,28/10/2021,10031061,775786,651946,123840,9255275,N,NULL,9,16/12/2020,NULL
253787,175674,12,28/11/2021,9370966,775786,660095,115691,8595180,N,NULL,9,16/12/2020,NULL
253788,175674,13,28/12/2021,8702619,775786,668347,107440,7926833,N,NULL,9,16/12/2020,NULL
253789,175674,14,28/01/2022,8025918,775786,676701,99085,7250132,N,NULL,9,16/12/2020,NULL
253790,175674,15,28/02/2022,7340758,775786,685160,90627,6564972,N,NULL,9,16/12/2020,NULL
253791,175674,16,28/03/2022,6647034,775786,693724,82062,5871248,N,NULL,9,16/12/2020,NULL
253792,175674,17,28/04/2022,5944638,775786,702396,73391,5168852,N,NULL,9,16/12/2020,NULL
253793,175674,18,28/05/2022,5233462,775786,711176,64611,4457676,N,NULL,9,16/12/2020,NULL
253794,175674,19,28/06/2022,4513397,775786,720065,55721,3737611,N,NULL,9,16/12/2020,NULL
253795,175674,20,28/07/2022,3784331,775786,729066,46720,3008545,N,NULL,9,16/12/2020,NULL
253796,175674,21,28/08/2022,3046151,775786,738180,37607,2270365,N,NULL,9,16/12/2020,NULL
253797,175674,22,28/09/2022,2298744,775786,747407,28380,1522958,N,NULL,9,16/12/2020,NULL
253798,175674,23,28/10/2022,1541995,775786,756749,19037,766209,N,NULL,9,16/12/2020,NULL
253799,175674,24,28/11/2022,775786,775786,766209,9578,0,N,NULL,9,16/12/2020,NULL
253800,175675,1,30/12/2020,16200000,380639,180639,200000,15819361,N,NULL,9,16/12/2020,NULL
253801,175675,2,30/01/2021,16017103,380639,182897,197742,15636464,N,NULL,9,16/12/2020,NULL
253802,175675,3,28/02/2021,15831920,380639,185183,195456,15451281,N,NULL,9,16/12/2020,NULL
253803,175675,4,28/03/2021,15644422,380639,187498,193141,15263783,N,NULL,9,16/12/2020,NULL
253804,175675,5,28/04/2021,15454580,380639,189842,190797,15073941,N,NULL,9,16/12/2020,NULL
253805,175675,6,28/05/2021,15262365,380639,192215,188424,14881726,N,NULL,9,16/12/2020,NULL
253806,175675,7,28/06/2021,15067748,380639,194617,186022,14687109,N,NULL,9,16/12/2020,NULL
253807,175675,8,28/07/2021,14870698,380639,197050,183589,14490059,N,NULL,9,16/12/2020,NULL
253808,175675,9,28/08/2021,14671185,380639,199513,181126,14290546,N,NULL,9,16/12/2020,NULL
253809,175675,10,28/09/2021,14469178,380639,202007,178632,14088539,N,NULL,9,16/12/2020,NULL
253810,175675,11,28/10/2021,14264646,380639,204532,176107,13884007,N,NULL,9,16/12/2020,NULL
253811,175675,12,28/11/2021,14057557,380639,207089,173550,13676918,N,NULL,9,16/12/2020,NULL
253812,175675,13,28/12/2021,13847880,380639,209677,170961,13467241,N,NULL,9,16/12/2020,NULL
253813,175675,14,28/01/2022,13635582,380639,212298,168341,13254943,N,NULL,9,16/12/2020,NULL
253814,175675,15,28/02/2022,13420630,380639,214952,165687,13039991,N,NULL,9,16/12/2020,NULL
253815,175675,16,28/03/2022,13202991,380639,217639,163000,12822352,N,NULL,9,16/12/2020,NULL
253816,175675,17,28/04/2022,12982632,380639,220359,160279,12601993,N,NULL,9,16/12/2020,NULL
253817,175675,18,28/05/2022,12759518,380639,223114,157525,12378879,N,NULL,9,16/12/2020,NULL
253818,175675,19,28/06/2022,12533615,380639,225903,154736,12152976,N,NULL,9,16/12/2020,NULL
253819,175675,20,28/07/2022,12304888,380639,228727,151912,11924249,N,NULL,9,16/12/2020,NULL
253820,175675,21,28/08/2022,12073302,380639,231586,149053,11692663,N,NULL,9,16/12/2020,NULL
253821,175675,22,28/09/2022,11838821,380639,234481,146158,11458182,N,NULL,9,16/12/2020,NULL
253822,175675,23,28/10/2022,11601409,380639,237412,143227,11220770,N,NULL,9,16/12/2020,NULL
253823,175675,24,28/11/2022,11361030,380639,240379,140260,10980391,N,NULL,9,16/12/2020,NULL
253824,175675,25,28/12/2022,11117646,380639,243384,137255,10737007,N,NULL,9,16/12/2020,NULL
253825,175675,26,28/01/2023,10871220,380639,246426,134213,10490581,N,NULL,9,16/12/2020,NULL
253826,175675,27,28/02/2023,10621713,380639,249507,131132,10241074,N,NULL,9,16/12/2020,NULL
253827,175675,28,28/03/2023,10369088,380639,252625,128013,9988449,N,NULL,9,16/12/2020,NULL
253828,175675,29,28/04/2023,10113305,380639,255783,124856,9732666,N,NULL,9,16/12/2020,NULL
253829,175675,30,28/05/2023,9854324,380639,258981,121658,9473685,N,NULL,9,16/12/2020,NULL
253830,175675,31,28/06/2023,9592106,380639,262218,118421,9211467,N,NULL,9,16/12/2020,NULL
253831,175675,32,28/07/2023,9326610,380639,265496,115143,8945971,N,NULL,9,16/12/2020,NULL
253832,175675,33,28/08/2023,9057796,380639,268814,111825,8677157,N,NULL,9,16/12/2020,NULL
253833,175675,34,28/09/2023,8785622,380639,272174,108464,8404983,N,NULL,9,16/12/2020,NULL
253834,175675,35,28/10/2023,8510045,380639,275577,105062,8129406,N,NULL,9,16/12/2020,NULL
253835,175675,36,28/11/2023,8231024,380639,279021,101618,7850385,N,NULL,9,16/12/2020,NULL
253836,175675,37,28/12/2023,7948515,380639,282509,98130,7567876,N,NULL,9,16/12/2020,NULL
253837,175675,38,28/01/2024,7662475,380639,286040,94598,7281836,N,NULL,9,16/12/2020,NULL
253838,175675,39,28/02/2024,7372859,380639,289616,91023,6992220,N,NULL,9,16/12/2020,NULL
253839,175675,40,28/03/2024,7079623,380639,293236,87403,6698984,N,NULL,9,16/12/2020,NULL
253840,175675,41,28/04/2024,6782721,380639,296902,83737,6402082,N,NULL,9,16/12/2020,NULL
253841,175675,42,28/05/2024,6482108,380639,300613,80026,6101469,N,NULL,9,16/12/2020,NULL
253842,175675,43,28/06/2024,6177737,380639,304371,76268,5797098,N,NULL,9,16/12/2020,NULL
253843,175675,44,28/07/2024,5869562,380639,308175,72464,5488923,N,NULL,9,16/12/2020,NULL
253844,175675,45,28/08/2024,5557535,380639,312027,68612,5176896,N,NULL,9,16/12/2020,NULL
253845,175675,46,28/09/2024,5241607,380639,315928,64711,4860968,N,NULL,9,16/12/2020,NULL
253846,175675,47,28/10/2024,4921730,380639,319877,60762,4541091,N,NULL,9,16/12/2020,NULL
253847,175675,48,28/11/2024,4597855,380639,323875,56764,4217216,N,NULL,9,16/12/2020,NULL
253848,175675,49,28/12/2024,4269931,380639,327924,52715,3889292,N,NULL,9,16/12/2020,NULL
253849,175675,50,28/01/2025,3937908,380639,332023,48616,3557269,N,NULL,9,16/12/2020,NULL
253850,175675,51,28/02/2025,3601735,380639,336173,44466,3221096,N,NULL,9,16/12/2020,NULL
253851,175675,52,28/03/2025,3261360,380639,340375,40264,2880721,N,NULL,9,16/12/2020,NULL
253852,175675,53,28/04/2025,2916730,380639,344630,36009,2536091,N,NULL,9,16/12/2020,NULL
253853,175675,54,28/05/2025,2567792,380639,348938,31701,2187153,N,NULL,9,16/12/2020,NULL
253854,175675,55,28/06/2025,2214493,380639,353299,27339,1833854,N,NULL,9,16/12/2020,NULL
253855,175675,56,28/07/2025,1856777,380639,357716,22923,1476138,N,NULL,9,16/12/2020,NULL
253856,175675,57,28/08/2025,1494590,380639,362187,18452,1113951,N,NULL,9,16/12/2020,NULL
253857,175675,58,28/09/2025,1127876,380639,366714,13924,747237,N,NULL,9,16/12/2020,NULL
253858,175675,59,28/10/2025,756578,380639,371298,9340,375939,N,NULL,9,16/12/2020,NULL
253859,175675,60,28/11/2025,380638,380639,375939,4699,0,N,NULL,9,16/12/2020,NULL
253860,175676,1,30/12/2020,16200000,380639,180639,200000,15819361,N,NULL,9,16/12/2020,NULL
253861,175676,2,30/01/2021,16017103,380639,182897,197742,15636464,N,NULL,9,16/12/2020,NULL
253862,175676,3,28/02/2021,15831920,380639,185183,195456,15451281,N,NULL,9,16/12/2020,NULL
253863,175676,4,28/03/2021,15644422,380639,187498,193141,15263783,N,NULL,9,16/12/2020,NULL
253864,175676,5,28/04/2021,15454580,380639,189842,190797,15073941,N,NULL,9,16/12/2020,NULL
253865,175676,6,28/05/2021,15262365,380639,192215,188424,14881726,N,NULL,9,16/12/2020,NULL
253866,175676,7,28/06/2021,15067748,380639,194617,186022,14687109,N,NULL,9,16/12/2020,NULL
253867,175676,8,28/07/2021,14870698,380639,197050,183589,14490059,N,NULL,9,16/12/2020,NULL
253868,175676,9,28/08/2021,14671185,380639,199513,181126,14290546,N,NULL,9,16/12/2020,NULL
253869,175676,10,28/09/2021,14469178,380639,202007,178632,14088539,N,NULL,9,16/12/2020,NULL
253870,175676,11,28/10/2021,14264646,380639,204532,176107,13884007,N,NULL,9,16/12/2020,NULL
253871,175676,12,28/11/2021,14057557,380639,207089,173550,13676918,N,NULL,9,16/12/2020,NULL
253872,175676,13,28/12/2021,13847880,380639,209677,170961,13467241,N,NULL,9,16/12/2020,NULL
253873,175676,14,28/01/2022,13635582,380639,212298,168341,13254943,N,NULL,9,16/12/2020,NULL
253874,175676,15,28/02/2022,13420630,380639,214952,165687,13039991,N,NULL,9,16/12/2020,NULL
253875,175676,16,28/03/2022,13202991,380639,217639,163000,12822352,N,NULL,9,16/12/2020,NULL
253876,175676,17,28/04/2022,12982632,380639,220359,160279,12601993,N,NULL,9,16/12/2020,NULL
253877,175676,18,28/05/2022,12759518,380639,223114,157525,12378879,N,NULL,9,16/12/2020,NULL
253878,175676,19,28/06/2022,12533615,380639,225903,154736,12152976,N,NULL,9,16/12/2020,NULL
253879,175676,20,28/07/2022,12304888,380639,228727,151912,11924249,N,NULL,9,16/12/2020,NULL
253880,175676,21,28/08/2022,12073302,380639,231586,149053,11692663,N,NULL,9,16/12/2020,NULL
253881,175676,22,28/09/2022,11838821,380639,234481,146158,11458182,N,NULL,9,16/12/2020,NULL
253882,175676,23,28/10/2022,11601409,380639,237412,143227,11220770,N,NULL,9,16/12/2020,NULL
253883,175676,24,28/11/2022,11361030,380639,240379,140260,10980391,N,NULL,9,16/12/2020,NULL
253884,175676,25,28/12/2022,11117646,380639,243384,137255,10737007,N,NULL,9,16/12/2020,NULL
253885,175676,26,28/01/2023,10871220,380639,246426,134213,10490581,N,NULL,9,16/12/2020,NULL
253886,175676,27,28/02/2023,10621713,380639,249507,131132,10241074,N,NULL,9,16/12/2020,NULL
253887,175676,28,28/03/2023,10369088,380639,252625,128013,9988449,N,NULL,9,16/12/2020,NULL
253888,175676,29,28/04/2023,10113305,380639,255783,124856,9732666,N,NULL,9,16/12/2020,NULL
253889,175676,30,28/05/2023,9854324,380639,258981,121658,9473685,N,NULL,9,16/12/2020,NULL
253890,175676,31,28/06/2023,9592106,380639,262218,118421,9211467,N,NULL,9,16/12/2020,NULL
253891,175676,32,28/07/2023,9326610,380639,265496,115143,8945971,N,NULL,9,16/12/2020,NULL
253892,175676,33,28/08/2023,9057796,380639,268814,111825,8677157,N,NULL,9,16/12/2020,NULL
253893,175676,34,28/09/2023,8785622,380639,272174,108464,8404983,N,NULL,9,16/12/2020,NULL
253894,175676,35,28/10/2023,8510045,380639,275577,105062,8129406,N,NULL,9,16/12/2020,NULL
253895,175676,36,28/11/2023,8231024,380639,279021,101618,7850385,N,NULL,9,16/12/2020,NULL
253896,175676,37,28/12/2023,7948515,380639,282509,98130,7567876,N,NULL,9,16/12/2020,NULL
253897,175676,38,28/01/2024,7662475,380639,286040,94598,7281836,N,NULL,9,16/12/2020,NULL
253898,175676,39,28/02/2024,7372859,380639,289616,91023,6992220,N,NULL,9,16/12/2020,NULL
253899,175676,40,28/03/2024,7079623,380639,293236,87403,6698984,N,NULL,9,16/12/2020,NULL
253900,175676,41,28/04/2024,6782721,380639,296902,83737,6402082,N,NULL,9,16/12/2020,NULL
253901,175676,42,28/05/2024,6482108,380639,300613,80026,6101469,N,NULL,9,16/12/2020,NULL
253902,175676,43,28/06/2024,6177737,380639,304371,76268,5797098,N,NULL,9,16/12/2020,NULL
253903,175676,44,28/07/2024,5869562,380639,308175,72464,5488923,N,NULL,9,16/12/2020,NULL
253904,175676,45,28/08/2024,5557535,380639,312027,68612,5176896,N,NULL,9,16/12/2020,NULL
253905,175676,46,28/09/2024,5241607,380639,315928,64711,4860968,N,NULL,9,16/12/2020,NULL
253906,175676,47,28/10/2024,4921730,380639,319877,60762,4541091,N,NULL,9,16/12/2020,NULL
253907,175676,48,28/11/2024,4597855,380639,323875,56764,4217216,N,NULL,9,16/12/2020,NULL
253908,175676,49,28/12/2024,4269931,380639,327924,52715,3889292,N,NULL,9,16/12/2020,NULL
253909,175676,50,28/01/2025,3937908,380639,332023,48616,3557269,N,NULL,9,16/12/2020,NULL
253910,175676,51,28/02/2025,3601735,380639,336173,44466,3221096,N,NULL,9,16/12/2020,NULL
253911,175676,52,28/03/2025,3261360,380639,340375,40264,2880721,N,NULL,9,16/12/2020,NULL
253912,175676,53,28/04/2025,2916730,380639,344630,36009,2536091,N,NULL,9,16/12/2020,NULL
253913,175676,54,28/05/2025,2567792,380639,348938,31701,2187153,N,NULL,9,16/12/2020,NULL
253914,175676,55,28/06/2025,2214493,380639,353299,27339,1833854,N,NULL,9,16/12/2020,NULL
253915,175676,56,28/07/2025,1856777,380639,357716,22923,1476138,N,NULL,9,16/12/2020,NULL
253916,175676,57,28/08/2025,1494590,380639,362187,18452,1113951,N,NULL,9,16/12/2020,NULL
253917,175676,58,28/09/2025,1127876,380639,366714,13924,747237,N,NULL,9,16/12/2020,NULL
253918,175676,59,28/10/2025,756578,380639,371298,9340,375939,N,NULL,9,16/12/2020,NULL
253919,175676,60,28/11/2025,380638,380639,375939,4699,0,N,NULL,9,16/12/2020,NULL
253920,175677,1,30/12/2020,16200000,380639,180639,200000,15819361,N,NULL,9,16/12/2020,NULL
253921,175677,2,30/01/2021,16017103,380639,182897,197742,15636464,N,NULL,9,16/12/2020,NULL
253922,175677,3,28/02/2021,15831920,380639,185183,195456,15451281,N,NULL,9,16/12/2020,NULL
253923,175677,4,28/03/2021,15644422,380639,187498,193141,15263783,N,NULL,9,16/12/2020,NULL
253924,175677,5,28/04/2021,15454580,380639,189842,190797,15073941,N,NULL,9,16/12/2020,NULL
253925,175677,6,28/05/2021,15262365,380639,192215,188424,14881726,N,NULL,9,16/12/2020,NULL
253926,175677,7,28/06/2021,15067748,380639,194617,186022,14687109,N,NULL,9,16/12/2020,NULL
253927,175677,8,28/07/2021,14870698,380639,197050,183589,14490059,N,NULL,9,16/12/2020,NULL
253928,175677,9,28/08/2021,14671185,380639,199513,181126,14290546,N,NULL,9,16/12/2020,NULL
253929,175677,10,28/09/2021,14469178,380639,202007,178632,14088539,N,NULL,9,16/12/2020,NULL
253930,175677,11,28/10/2021,14264646,380639,204532,176107,13884007,N,NULL,9,16/12/2020,NULL
253931,175677,12,28/11/2021,14057557,380639,207089,173550,13676918,N,NULL,9,16/12/2020,NULL
253932,175677,13,28/12/2021,13847880,380639,209677,170961,13467241,N,NULL,9,16/12/2020,NULL
253933,175677,14,28/01/2022,13635582,380639,212298,168341,13254943,N,NULL,9,16/12/2020,NULL
253934,175677,15,28/02/2022,13420630,380639,214952,165687,13039991,N,NULL,9,16/12/2020,NULL
253935,175677,16,28/03/2022,13202991,380639,217639,163000,12822352,N,NULL,9,16/12/2020,NULL
253936,175677,17,28/04/2022,12982632,380639,220359,160279,12601993,N,NULL,9,16/12/2020,NULL
253937,175677,18,28/05/2022,12759518,380639,223114,157525,12378879,N,NULL,9,16/12/2020,NULL
253938,175677,19,28/06/2022,12533615,380639,225903,154736,12152976,N,NULL,9,16/12/2020,NULL
253939,175677,20,28/07/2022,12304888,380639,228727,151912,11924249,N,NULL,9,16/12/2020,NULL
253940,175677,21,28/08/2022,12073302,380639,231586,149053,11692663,N,NULL,9,16/12/2020,NULL
253941,175677,22,28/09/2022,11838821,380639,234481,146158,11458182,N,NULL,9,16/12/2020,NULL
253942,175677,23,28/10/2022,11601409,380639,237412,143227,11220770,N,NULL,9,16/12/2020,NULL
253943,175677,24,28/11/2022,11361030,380639,240379,140260,10980391,N,NULL,9,16/12/2020,NULL
253944,175677,25,28/12/2022,11117646,380639,243384,137255,10737007,N,NULL,9,16/12/2020,NULL
253945,175677,26,28/01/2023,10871220,380639,246426,134213,10490581,N,NULL,9,16/12/2020,NULL
253946,175677,27,28/02/2023,10621713,380639,249507,131132,10241074,N,NULL,9,16/12/2020,NULL
253947,175677,28,28/03/2023,10369088,380639,252625,128013,9988449,N,NULL,9,16/12/2020,NULL
253948,175677,29,28/04/2023,10113305,380639,255783,124856,9732666,N,NULL,9,16/12/2020,NULL
253949,175677,30,28/05/2023,9854324,380639,258981,121658,9473685,N,NULL,9,16/12/2020,NULL
253950,175677,31,28/06/2023,9592106,380639,262218,118421,9211467,N,NULL,9,16/12/2020,NULL
253951,175677,32,28/07/2023,9326610,380639,265496,115143,8945971,N,NULL,9,16/12/2020,NULL
253952,175677,33,28/08/2023,9057796,380639,268814,111825,8677157,N,NULL,9,16/12/2020,NULL
253953,175677,34,28/09/2023,8785622,380639,272174,108464,8404983,N,NULL,9,16/12/2020,NULL
253954,175677,35,28/10/2023,8510045,380639,275577,105062,8129406,N,NULL,9,16/12/2020,NULL
253955,175677,36,28/11/2023,8231024,380639,279021,101618,7850385,N,NULL,9,16/12/2020,NULL
253956,175677,37,28/12/2023,7948515,380639,282509,98130,7567876,N,NULL,9,16/12/2020,NULL
253957,175677,38,28/01/2024,7662475,380639,286040,94598,7281836,N,NULL,9,16/12/2020,NULL
253958,175677,39,28/02/2024,7372859,380639,289616,91023,6992220,N,NULL,9,16/12/2020,NULL
253959,175677,40,28/03/2024,7079623,380639,293236,87403,6698984,N,NULL,9,16/12/2020,NULL
253960,175677,41,28/04/2024,6782721,380639,296902,83737,6402082,N,NULL,9,16/12/2020,NULL
253961,175677,42,28/05/2024,6482108,380639,300613,80026,6101469,N,NULL,9,16/12/2020,NULL
253962,175677,43,28/06/2024,6177737,380639,304371,76268,5797098,N,NULL,9,16/12/2020,NULL
253963,175677,44,28/07/2024,5869562,380639,308175,72464,5488923,N,NULL,9,16/12/2020,NULL
253964,175677,45,28/08/2024,5557535,380639,312027,68612,5176896,N,NULL,9,16/12/2020,NULL
253965,175677,46,28/09/2024,5241607,380639,315928,64711,4860968,N,NULL,9,16/12/2020,NULL
253966,175677,47,28/10/2024,4921730,380639,319877,60762,4541091,N,NULL,9,16/12/2020,NULL
253967,175677,48,28/11/2024,4597855,380639,323875,56764,4217216,N,NULL,9,16/12/2020,NULL
253968,175677,49,28/12/2024,4269931,380639,327924,52715,3889292,N,NULL,9,16/12/2020,NULL
253969,175677,50,28/01/2025,3937908,380639,332023,48616,3557269,N,NULL,9,16/12/2020,NULL
253970,175677,51,28/02/2025,3601735,380639,336173,44466,3221096,N,NULL,9,16/12/2020,NULL
253971,175677,52,28/03/2025,3261360,380639,340375,40264,2880721,N,NULL,9,16/12/2020,NULL
253972,175677,53,28/04/2025,2916730,380639,344630,36009,2536091,N,NULL,9,16/12/2020,NULL
253973,175677,54,28/05/2025,2567792,380639,348938,31701,2187153,N,NULL,9,16/12/2020,NULL
253974,175677,55,28/06/2025,2214493,380639,353299,27339,1833854,N,NULL,9,16/12/2020,NULL
253975,175677,56,28/07/2025,1856777,380639,357716,22923,1476138,N,NULL,9,16/12/2020,NULL
253976,175677,57,28/08/2025,1494590,380639,362187,18452,1113951,N,NULL,9,16/12/2020,NULL
253977,175677,58,28/09/2025,1127876,380639,366714,13924,747237,N,NULL,9,16/12/2020,NULL
253978,175677,59,28/10/2025,756578,380639,371298,9340,375939,N,NULL,9,16/12/2020,NULL
253979,175677,60,28/11/2025,380638,380639,375939,4699,0,N,NULL,9,16/12/2020,NULL
253980,175678,1,2/1/2021,16200000,445292,245292,200000,15754708,N,NULL,9,16/12/2020,NULL
253981,175678,2,2/2/2021,15951642,445292,248358,196934,15506350,N,NULL,9,16/12/2020,NULL
253982,175678,3,2/3/2021,15700179,445292,251463,193829,15254887,N,NULL,9,16/12/2020,NULL
253983,175678,4,2/4/2021,15445573,445292,254606,190686,15000281,N,NULL,9,16/12/2020,NULL
253984,175678,5,2/5/2021,15187785,445292,257788,187504,14742493,N,NULL,9,16/12/2020,NULL
253985,175678,6,2/6/2021,14926774,445292,261011,184281,14481482,N,NULL,9,16/12/2020,NULL
253986,175678,7,2/7/2021,14662501,445292,264273,181019,14217209,N,NULL,9,16/12/2020,NULL
253987,175678,8,2/8/2021,14394924,445292,267577,177715,13949632,N,NULL,9,16/12/2020,NULL
253988,175678,9,2/9/2021,14124002,445292,270922,174370,13678710,N,NULL,9,16/12/2020,NULL
253989,175678,10,2/10/2021,13849694,445292,274308,170984,13404402,N,NULL,9,16/12/2020,NULL
253990,175678,11,2/11/2021,13571957,445292,277737,167555,13126665,N,NULL,9,16/12/2020,NULL
253991,175678,12,2/12/2021,13290748,445292,281209,164083,12845456,N,NULL,9,16/12/2020,NULL
253992,175678,13,2/1/2022,13006024,445292,284724,160568,12560732,N,NULL,9,16/12/2020,NULL
253993,175678,14,2/2/2022,12717741,445292,288283,157009,12272449,N,NULL,9,16/12/2020,NULL
253994,175678,15,2/3/2022,12425855,445292,291886,153406,11980563,N,NULL,9,16/12/2020,NULL
253995,175678,16,2/4/2022,12130320,445292,295535,149757,11685028,N,NULL,9,16/12/2020,NULL
253996,175678,17,2/5/2022,11831091,445292,299229,146063,11385799,N,NULL,9,16/12/2020,NULL
253997,175678,18,2/6/2022,11528122,445292,302969,142322,11082830,N,NULL,9,16/12/2020,NULL
253998,175678,19,2/7/2022,11221365,445292,306757,138535,10776073,N,NULL,9,16/12/2020,NULL
253999,175678,20,2/8/2022,10910774,445292,310591,134701,10465482,N,NULL,9,16/12/2020,NULL
254000,175678,21,2/9/2022,10596301,445292,314473,130819,10151009,N,NULL,9,16/12/2020,NULL
254001,175678,22,2/10/2022,10277897,445292,318404,126888,9832605,N,NULL,9,16/12/2020,NULL
254002,175678,23,2/11/2022,9955513,445292,322384,122908,9510221,N,NULL,9,16/12/2020,NULL
254003,175678,24,2/12/2022,9629099,445292,326414,118878,9183807,N,NULL,9,16/12/2020,NULL
254004,175678,25,2/1/2023,9298605,445292,330494,114798,8853313,N,NULL,9,16/12/2020,NULL
254005,175678,26,2/2/2023,8963979,445292,334626,110666,8518687,N,NULL,9,16/12/2020,NULL
254006,175678,27,2/3/2023,8625171,445292,338808,106484,8179879,N,NULL,9,16/12/2020,NULL
254007,175678,28,2/4/2023,8282127,445292,343044,102248,7836835,N,NULL,9,16/12/2020,NULL
254008,175678,29,2/5/2023,7934795,445292,347332,97960,7489503,N,NULL,9,16/12/2020,NULL
254009,175678,30,2/6/2023,7583122,445292,351673,93619,7137830,N,NULL,9,16/12/2020,NULL
254010,175678,31,2/7/2023,7227053,445292,356069,89223,6781761,N,NULL,9,16/12/2020,NULL
254011,175678,32,2/8/2023,6866533,445292,360520,84772,6421241,N,NULL,9,16/12/2020,NULL
254012,175678,33,2/9/2023,6501507,445292,365026,80266,6056215,N,NULL,9,16/12/2020,NULL
254013,175678,34,2/10/2023,6131918,445292,369589,75703,5686626,N,NULL,9,16/12/2020,NULL
254014,175678,35,2/11/2023,5757709,445292,374209,71083,5312417,N,NULL,9,16/12/2020,NULL
254015,175678,36,2/12/2023,5378822,445292,378887,66405,4933530,N,NULL,9,16/12/2020,NULL
254016,175678,37,2/1/2024,4995199,445292,383623,61669,4549907,N,NULL,9,16/12/2020,NULL
254017,175678,38,2/2/2024,4606781,445292,388418,56874,4161489,N,NULL,9,16/12/2020,NULL
254018,175678,39,2/3/2024,4213508,445292,393273,52019,3768216,N,NULL,9,16/12/2020,NULL
254019,175678,40,2/4/2024,3815319,445292,398189,47103,3370027,N,NULL,9,16/12/2020,NULL
254020,175678,41,2/5/2024,3412152,445292,403167,42125,2966860,N,NULL,9,16/12/2020,NULL
254021,175678,42,2/6/2024,3003946,445292,408206,37086,2558654,N,NULL,9,16/12/2020,NULL
254022,175678,43,2/7/2024,2590637,445292,413309,31983,2145345,N,NULL,9,16/12/2020,NULL
254023,175678,44,2/8/2024,2172162,445292,418475,26817,1726870,N,NULL,9,16/12/2020,NULL
254024,175678,45,2/9/2024,1748456,445292,423706,21586,1303164,N,NULL,9,16/12/2020,NULL
254025,175678,46,2/10/2024,1319454,445292,429002,16290,874162,N,NULL,9,16/12/2020,NULL
254026,175678,47,2/11/2024,885089,445292,434365,10927,439797,N,NULL,9,16/12/2020,NULL
254027,175678,48,2/12/2024,445294,445292,439797,5497,0,N,NULL,9,16/12/2020,NULL
254028,175679,1,2/1/2021,17753484,417140,197961,219179,17336344,N,NULL,9,16/12/2020,NULL
254029,175679,2,2/2/2021,17553048,417140,200436,216704,17135908,N,NULL,9,16/12/2020,NULL
254030,175679,3,2/3/2021,17350107,417140,202941,214199,16932967,N,NULL,9,16/12/2020,NULL
254031,175679,4,2/4/2021,17144629,417140,205478,211662,16727489,N,NULL,9,16/12/2020,NULL
254032,175679,5,2/5/2021,16936583,417140,208046,209094,16519443,N,NULL,9,16/12/2020,NULL
254033,175679,6,2/6/2021,16725936,417140,210647,206493,16308796,N,NULL,9,16/12/2020,NULL
254034,175679,7,2/7/2021,16512656,417140,213280,203860,16095516,N,NULL,9,16/12/2020,NULL
254035,175679,8,2/8/2021,16296710,417140,215946,201194,15879570,N,NULL,9,16/12/2020,NULL
254036,175679,9,2/9/2021,16078065,417140,218645,198495,15660925,N,NULL,9,16/12/2020,NULL
254037,175679,10,2/10/2021,15856687,417140,221378,195762,15439547,N,NULL,9,16/12/2020,NULL
254038,175679,11,2/11/2021,15632541,417140,224146,192994,15215401,N,NULL,9,16/12/2020,NULL
254039,175679,12,2/12/2021,15405594,417140,226947,190193,14988454,N,NULL,9,16/12/2020,NULL
254040,175679,13,2/1/2022,15175810,417140,229784,187356,14758670,N,NULL,9,16/12/2020,NULL
254041,175679,14,2/2/2022,14943153,417140,232657,184483,14526013,N,NULL,9,16/12/2020,NULL
254042,175679,15,2/3/2022,14707588,417140,235565,181575,14290448,N,NULL,9,16/12/2020,NULL
254043,175679,16,2/4/2022,14469079,417140,238509,178631,14051939,N,NULL,9,16/12/2020,NULL
254044,175679,17,2/5/2022,14227588,417140,241491,175649,13810448,N,NULL,9,16/12/2020,NULL
254045,175679,18,2/6/2022,13983079,417140,244509,172631,13565939,N,NULL,9,16/12/2020,NULL
254046,175679,19,2/7/2022,13735513,417140,247566,169574,13318373,N,NULL,9,16/12/2020,NULL
254047,175679,20,2/8/2022,13484853,417140,250660,166480,13067713,N,NULL,9,16/12/2020,NULL
254048,175679,21,2/9/2022,13231060,417140,253793,163346,12813920,N,NULL,9,16/12/2020,NULL
254049,175679,22,2/10/2022,12974094,417140,256966,160174,12556954,N,NULL,9,16/12/2020,NULL
254050,175679,23,2/11/2022,12713916,417140,260178,156962,12296776,N,NULL,9,16/12/2020,NULL
254051,175679,24,2/12/2022,12450486,417140,263430,153710,12033346,N,NULL,9,16/12/2020,NULL
254052,175679,25,2/1/2023,12183763,417140,266723,150417,11766623,N,NULL,9,16/12/2020,NULL
254053,175679,26,2/2/2023,11913706,417140,270057,147083,11496566,N,NULL,9,16/12/2020,NULL
254054,175679,27,2/3/2023,11640273,417140,273433,143707,11223133,N,NULL,9,16/12/2020,NULL
254055,175679,28,2/4/2023,11363422,417140,276851,140289,10946282,N,NULL,9,16/12/2020,NULL
254056,175679,29,2/5/2023,11083111,417140,280311,136829,10665971,N,NULL,9,16/12/2020,NULL
254057,175679,30,2/6/2023,10799296,417140,283815,133325,10382156,N,NULL,9,16/12/2020,NULL
254058,175679,31,2/7/2023,10511933,417140,287363,129777,10094793,N,NULL,9,16/12/2020,NULL
254059,175679,32,2/8/2023,10220978,417140,290955,126185,9803838,N,NULL,9,16/12/2020,NULL
254060,175679,33,2/9/2023,9926386,417140,294592,122548,9509246,N,NULL,9,16/12/2020,NULL
254061,175679,34,2/10/2023,9628112,417140,298274,118866,9210972,N,NULL,9,16/12/2020,NULL
254062,175679,35,2/11/2023,9326109,417140,302003,115137,8908969,N,NULL,9,16/12/2020,NULL
254063,175679,36,2/12/2023,9020331,417140,305778,111362,8603191,N,NULL,9,16/12/2020,NULL
254064,175679,37,2/1/2024,8710731,417140,309600,107540,8293591,N,NULL,9,16/12/2020,NULL
254065,175679,38,2/2/2024,8397261,417140,313470,103670,7980121,N,NULL,9,16/12/2020,NULL
254066,175679,39,2/3/2024,8079873,417140,317388,99752,7662733,N,NULL,9,16/12/2020,NULL
254067,175679,40,2/4/2024,7758517,417140,321356,95784,7341377,N,NULL,9,16/12/2020,NULL
254068,175679,41,2/5/2024,7433144,417140,325373,91767,7016004,N,NULL,9,16/12/2020,NULL
254069,175679,42,2/6/2024,7103704,417140,329440,87700,6686564,N,NULL,9,16/12/2020,NULL
254070,175679,43,2/7/2024,6770146,417140,333558,83582,6353006,N,NULL,9,16/12/2020,NULL
254071,175679,44,2/8/2024,6432419,417140,337727,79413,6015279,N,NULL,9,16/12/2020,NULL
254072,175679,45,2/9/2024,6090470,417140,341949,75191,5673330,N,NULL,9,16/12/2020,NULL
254073,175679,46,2/10/2024,5744247,417140,346223,70917,5327107,N,NULL,9,16/12/2020,NULL
254074,175679,47,2/11/2024,5393696,417140,350551,66589,4976556,N,NULL,9,16/12/2020,NULL
254075,175679,48,2/12/2024,5038763,417140,354933,62207,4621623,N,NULL,9,16/12/2020,NULL
254076,175679,49,2/1/2025,4679393,417140,359370,57770,4262253,N,NULL,9,16/12/2020,NULL
254077,175679,50,2/2/2025,4315531,417140,363862,53278,3898391,N,NULL,9,16/12/2020,NULL
254078,175679,51,2/3/2025,3947121,417140,368410,48730,3529981,N,NULL,9,16/12/2020,NULL
254079,175679,52,2/4/2025,3574106,417140,373015,44125,3156966,N,NULL,9,16/12/2020,NULL
254080,175679,53,2/5/2025,3196428,417140,377678,39462,2779288,N,NULL,9,16/12/2020,NULL
254081,175679,54,2/6/2025,2814029,417140,382399,34741,2396889,N,NULL,9,16/12/2020,NULL
254082,175679,55,2/7/2025,2426850,417140,387179,29961,2009710,N,NULL,9,16/12/2020,NULL
254083,175679,56,2/8/2025,2034831,417140,392019,25121,1617691,N,NULL,9,16/12/2020,NULL
254084,175679,57,2/9/2025,1637912,417140,396919,20221,1220772,N,NULL,9,16/12/2020,NULL
254085,175679,58,2/10/2025,1236032,417140,401880,15260,818892,N,NULL,9,16/12/2020,NULL
254086,175679,59,2/11/2025,829128,417140,406904,10236,411988,N,NULL,9,16/12/2020,NULL
254087,175679,60,2/12/2025,417138,417140,411988,5150,0,N,NULL,9,16/12/2020,NULL
254088,175680,1,2/1/2021,27576132,647935,307489,340446,26928197,N,NULL,9,16/12/2020,NULL
254089,175680,2,2/2/2021,27264799,647935,311333,336602,26616864,N,NULL,9,16/12/2020,NULL
254090,175680,3,2/3/2021,26949575,647935,315224,332711,26301640,N,NULL,9,16/12/2020,NULL
254091,175680,4,2/4/2021,26630410,647935,319165,328771,25982475,N,NULL,9,16/12/2020,NULL
254092,175680,5,2/5/2021,26307256,647935,323154,324781,25659321,N,NULL,9,16/12/2020,NULL
254093,175680,6,2/6/2021,25980062,647935,327194,320742,25332127,N,NULL,9,16/12/2020,NULL
254094,175680,7,2/7/2021,25648779,647935,331283,316652,25000844,N,NULL,9,16/12/2020,NULL
254095,175680,8,2/8/2021,25313354,647935,335425,312511,24665419,N,NULL,9,16/12/2020,NULL
254096,175680,9,2/9/2021,24973737,647935,339617,308318,24325802,N,NULL,9,16/12/2020,NULL
254097,175680,10,2/10/2021,24629874,647935,343863,304073,23981939,N,NULL,9,16/12/2020,NULL
254098,175680,11,2/11/2021,24281713,647935,348161,299774,23633778,N,NULL,9,16/12/2020,NULL
254099,175680,12,2/12/2021,23929200,647935,352513,295422,23281265,N,NULL,9,16/12/2020,NULL
254100,175680,13,2/1/2022,23572281,647935,356919,291016,22924346,N,NULL,9,16/12/2020,NULL
254101,175680,14,2/2/2022,23210900,647935,361381,286554,22562965,N,NULL,9,16/12/2020,NULL
254102,175680,15,2/3/2022,22845002,647935,365898,282037,22197067,N,NULL,9,16/12/2020,NULL
254103,175680,16,2/4/2022,22474530,647935,370472,277463,21826595,N,NULL,9,16/12/2020,NULL
254104,175680,17,2/5/2022,22099427,647935,375103,272832,21451492,N,NULL,9,16/12/2020,NULL
254105,175680,18,2/6/2022,21719636,647935,379791,268144,21071701,N,NULL,9,16/12/2020,NULL
254106,175680,19,2/7/2022,21335097,647935,384539,263396,20687162,N,NULL,9,16/12/2020,NULL
254107,175680,20,2/8/2022,20945751,647935,389346,258590,20297816,N,NULL,9,16/12/2020,NULL
254108,175680,21,2/9/2022,20551539,647935,394212,253723,19903604,N,NULL,9,16/12/2020,NULL
254109,175680,22,2/10/2022,20152399,647935,399140,248795,19504464,N,NULL,9,16/12/2020,NULL
254110,175680,23,2/11/2022,19748270,647935,404129,243806,19100335,N,NULL,9,16/12/2020,NULL
254111,175680,24,2/12/2022,19339089,647935,409181,238754,18691154,N,NULL,9,16/12/2020,NULL
254112,175680,25,2/1/2023,18924793,647935,414296,233639,18276858,N,NULL,9,16/12/2020,NULL
254113,175680,26,2/2/2023,18505319,647935,419474,228461,17857384,N,NULL,9,16/12/2020,NULL
254114,175680,27,2/3/2023,18080601,647935,424718,223217,17432666,N,NULL,9,16/12/2020,NULL
254115,175680,28,2/4/2023,17650574,647935,430027,217908,17002639,N,NULL,9,16/12/2020,NULL
254116,175680,29,2/5/2023,17215172,647935,435402,212533,16567237,N,NULL,9,16/12/2020,NULL
254117,175680,30,2/6/2023,16774327,647935,440845,207090,16126392,N,NULL,9,16/12/2020,NULL
254118,175680,31,2/7/2023,16327972,647935,446355,201580,15680037,N,NULL,9,16/12/2020,NULL
254119,175680,32,2/8/2023,15876037,647935,451935,196000,15228102,N,NULL,9,16/12/2020,NULL
254120,175680,33,2/9/2023,15418453,647935,457584,190351,14770518,N,NULL,9,16/12/2020,NULL
254121,175680,34,2/10/2023,14955149,647935,463304,184632,14307214,N,NULL,9,16/12/2020,NULL
254122,175680,35,2/11/2023,14486054,647935,469095,178840,13838119,N,NULL,9,16/12/2020,NULL
254123,175680,36,2/12/2023,14011095,647935,474959,172977,13363160,N,NULL,9,16/12/2020,NULL
254124,175680,37,2/1/2024,13530199,647935,480896,167040,12882264,N,NULL,9,16/12/2020,NULL
254125,175680,38,2/2/2024,13043292,647935,486907,161028,12395357,N,NULL,9,16/12/2020,NULL
254126,175680,39,2/3/2024,12550299,647935,492993,154942,11902364,N,NULL,9,16/12/2020,NULL
254127,175680,40,2/4/2024,12051144,647935,499155,148780,11403209,N,NULL,9,16/12/2020,NULL
254128,175680,41,2/5/2024,11545749,647935,505395,142540,10897814,N,NULL,9,16/12/2020,NULL
254129,175680,42,2/6/2024,11034037,647935,511712,136223,10386102,N,NULL,9,16/12/2020,NULL
254130,175680,43,2/7/2024,10515928,647935,518109,129826,9867993,N,NULL,9,16/12/2020,NULL
254131,175680,44,2/8/2024,9991343,647935,524585,123350,9343408,N,NULL,9,16/12/2020,NULL
254132,175680,45,2/9/2024,9460201,647935,531142,116793,8812266,N,NULL,9,16/12/2020,NULL
254133,175680,46,2/10/2024,8922419,647935,537782,110153,8274484,N,NULL,9,16/12/2020,NULL
254134,175680,47,2/11/2024,8377915,647935,544504,103431,7729980,N,NULL,9,16/12/2020,NULL
254135,175680,48,2/12/2024,7826605,647935,551310,96625,7178670,N,NULL,9,16/12/2020,NULL
254136,175680,49,2/1/2025,7268403,647935,558202,89733,6620468,N,NULL,9,16/12/2020,NULL
254137,175680,50,2/2/2025,6703224,647935,565179,82756,6055289,N,NULL,9,16/12/2020,NULL
254138,175680,51,2/3/2025,6130980,647935,572244,75691,5483045,N,NULL,9,16/12/2020,NULL
254139,175680,52,2/4/2025,5551583,647935,579397,68538,4903648,N,NULL,9,16/12/2020,NULL
254140,175680,53,2/5/2025,4964944,647935,586639,61296,4317009,N,NULL,9,16/12/2020,NULL
254141,175680,54,2/6/2025,4370972,647935,593972,53963,3723037,N,NULL,9,16/12/2020,NULL
254142,175680,55,2/7/2025,3769575,647935,601397,46538,3121640,N,NULL,9,16/12/2020,NULL
254143,175680,56,2/8/2025,3160660,647935,608915,39021,2512725,N,NULL,9,16/12/2020,NULL
254144,175680,57,2/9/2025,2544134,647935,616526,31409,1896199,N,NULL,9,16/12/2020,NULL
254145,175680,58,2/10/2025,1919901,647935,624233,23703,1271966,N,NULL,9,16/12/2020,NULL
254146,175680,59,2/11/2025,1287866,647935,632035,15900,639931,N,NULL,9,16/12/2020,NULL
254147,175680,60,2/12/2025,647930,647935,639931,7999,0,N,NULL,9,16/12/2020,NULL
254148,175681,1,2/1/2021,8100000,190319,90319,100000,7909681,N,NULL,9,16/12/2020,NULL
254149,175681,2,2/2/2021,8008552,190319,91448,98871,7818233,N,NULL,9,16/12/2020,NULL
254150,175681,3,2/3/2021,7915960,190319,92592,97728,7725641,N,NULL,9,16/12/2020,NULL
254151,175681,4,2/4/2021,7822211,190319,93749,96571,7631892,N,NULL,9,16/12/2020,NULL
254152,175681,5,2/5/2021,7727290,190319,94921,95399,7536971,N,NULL,9,16/12/2020,NULL
254153,175681,6,2/6/2021,7631183,190319,96107,94212,7440864,N,NULL,9,16/12/2020,NULL
254154,175681,7,2/7/2021,7533874,190319,97309,93011,7343555,N,NULL,9,16/12/2020,NULL
254155,175681,8,2/8/2021,7435349,190319,98525,91794,7245030,N,NULL,9,16/12/2020,NULL
254156,175681,9,2/9/2021,7335592,190319,99757,90563,7145273,N,NULL,9,16/12/2020,NULL
254157,175681,10,2/10/2021,7234588,190319,101004,89316,7044269,N,NULL,9,16/12/2020,NULL
254158,175681,11,2/11/2021,7132322,190319,102266,88053,6942003,N,NULL,9,16/12/2020,NULL
254159,175681,12,2/12/2021,7028778,190319,103544,86775,6838459,N,NULL,9,16/12/2020,NULL
254160,175681,13,2/1/2022,6923939,190319,104839,85481,6733620,N,NULL,9,16/12/2020,NULL
254161,175681,14,2/2/2022,6817790,190319,106149,84170,6627471,N,NULL,9,16/12/2020,NULL
254162,175681,15,2/3/2022,6710314,190319,107476,82843,6519995,N,NULL,9,16/12/2020,NULL
254163,175681,16,2/4/2022,6601495,190319,108819,81500,6411176,N,NULL,9,16/12/2020,NULL
254164,175681,17,2/5/2022,6491315,190319,110180,80140,6300996,N,NULL,9,16/12/2020,NULL
254165,175681,18,2/6/2022,6379758,190319,111557,78762,6189439,N,NULL,9,16/12/2020,NULL
254166,175681,19,2/7/2022,6266807,190319,112951,77368,6076488,N,NULL,9,16/12/2020,NULL
254167,175681,20,2/8/2022,6152444,190319,114363,75956,5962125,N,NULL,9,16/12/2020,NULL
254168,175681,21,2/9/2022,6036651,190319,115793,74527,5846332,N,NULL,9,16/12/2020,NULL
254169,175681,22,2/10/2022,5919411,190319,117240,73079,5729092,N,NULL,9,16/12/2020,NULL
254170,175681,23,2/11/2022,5800705,190319,118706,71614,5610386,N,NULL,9,16/12/2020,NULL
254171,175681,24,2/12/2022,5680515,190319,120190,70130,5490196,N,NULL,9,16/12/2020,NULL
254172,175681,25,2/1/2023,5558823,190319,121692,68627,5368504,N,NULL,9,16/12/2020,NULL
254173,175681,26,2/2/2023,5435610,190319,123213,67106,5245291,N,NULL,9,16/12/2020,NULL
254174,175681,27,2/3/2023,5310857,190319,124753,65566,5120538,N,NULL,9,16/12/2020,NULL
254175,175681,28,2/4/2023,5184544,190319,126313,64007,4994225,N,NULL,9,16/12/2020,NULL
254176,175681,29,2/5/2023,5056652,190319,127892,62428,4866333,N,NULL,9,16/12/2020,NULL
254177,175681,30,2/6/2023,4927162,190319,129490,60829,4736843,N,NULL,9,16/12/2020,NULL
254178,175681,31,2/7/2023,4796053,190319,131109,59211,4605734,N,NULL,9,16/12/2020,NULL
254179,175681,32,2/8/2023,4663305,190319,132748,57572,4472986,N,NULL,9,16/12/2020,NULL
254180,175681,33,2/9/2023,4528898,190319,134407,55912,4338579,N,NULL,9,16/12/2020,NULL
254181,175681,34,2/10/2023,4392811,190319,136087,54232,4202492,N,NULL,9,16/12/2020,NULL
254182,175681,35,2/11/2023,4255023,190319,137788,52531,4064704,N,NULL,9,16/12/2020,NULL
254183,175681,36,2/12/2023,4115512,190319,139511,50809,3925193,N,NULL,9,16/12/2020,NULL
254184,175681,37,2/1/2024,3974257,190319,141255,49065,3783938,N,NULL,9,16/12/2020,NULL
254185,175681,38,2/2/2024,3831237,190319,143020,47299,3640918,N,NULL,9,16/12/2020,NULL
254186,175681,39,2/3/2024,3686429,190319,144808,45511,3496110,N,NULL,9,16/12/2020,NULL
254187,175681,40,2/4/2024,3539811,190319,146618,43701,3349492,N,NULL,9,16/12/2020,NULL
254188,175681,41,2/5/2024,3391360,190319,148451,41869,3201041,N,NULL,9,16/12/2020,NULL
254189,175681,42,2/6/2024,3241054,190319,150306,40013,3050735,N,NULL,9,16/12/2020,NULL
254190,175681,43,2/7/2024,3088869,190319,152185,38134,2898550,N,NULL,9,16/12/2020,NULL
254191,175681,44,2/8/2024,2934781,190319,154088,36232,2744462,N,NULL,9,16/12/2020,NULL
254192,175681,45,2/9/2024,2778767,190319,156014,34306,2588448,N,NULL,9,16/12/2020,NULL
254193,175681,46,2/10/2024,2620803,190319,157964,32356,2430484,N,NULL,9,16/12/2020,NULL
254194,175681,47,2/11/2024,2460865,190319,159938,30381,2270546,N,NULL,9,16/12/2020,NULL
254195,175681,48,2/12/2024,2298927,190319,161938,28382,2108608,N,NULL,9,16/12/2020,NULL
254196,175681,49,2/1/2025,2134965,190319,163962,26358,1944646,N,NULL,9,16/12/2020,NULL
254197,175681,50,2/2/2025,1968954,190319,166011,24308,1778635,N,NULL,9,16/12/2020,NULL
254198,175681,51,2/3/2025,1800868,190319,168086,22233,1610549,N,NULL,9,16/12/2020,NULL
254199,175681,52,2/4/2025,1630680,190319,170188,20132,1440361,N,NULL,9,16/12/2020,NULL
254200,175681,53,2/5/2025,1458365,190319,172315,18005,1268046,N,NULL,9,16/12/2020,NULL
254201,175681,54,2/6/2025,1283896,190319,174469,15851,1093577,N,NULL,9,16/12/2020,NULL
254202,175681,55,2/7/2025,1107246,190319,176650,13670,916927,N,NULL,9,16/12/2020,NULL
254203,175681,56,2/8/2025,928388,190319,178858,11462,738069,N,NULL,9,16/12/2020,NULL
254204,175681,57,2/9/2025,747294,190319,181094,9226,556975,N,NULL,9,16/12/2020,NULL
254205,175681,58,2/10/2025,563937,190319,183357,6962,373618,N,NULL,9,16/12/2020,NULL
254206,175681,59,2/11/2025,378288,190319,185649,4670,187969,N,NULL,9,16/12/2020,NULL
254207,175681,60,2/12/2025,190318,190319,187969,2350,0,N,NULL,9,16/12/2020,NULL
254208,175682,1,2/1/2021,11137500,1076552,939052,137500,10060948,N,NULL,9,16/12/2020,NULL
254209,175682,2,2/2/2021,10186710,1076552,950790,125762,9110158,N,NULL,9,16/12/2020,NULL
254210,175682,3,2/3/2021,9224035,1076552,962675,113877,8147483,N,NULL,9,16/12/2020,NULL
254211,175682,4,2/4/2021,8249326,1076552,974709,101844,7172774,N,NULL,9,16/12/2020,NULL
254212,175682,5,2/5/2021,7262433,1076552,986893,89660,6185881,N,NULL,9,16/12/2020,NULL
254213,175682,6,2/6/2021,6263204,1076552,999229,77324,5186652,N,NULL,9,16/12/2020,NULL
254214,175682,7,2/7/2021,5251485,1076552,1011719,64833,4174933,N,NULL,9,16/12/2020,NULL
254215,175682,8,2/8/2021,4227119,1076552,1024366,52187,3150567,N,NULL,9,16/12/2020,NULL
254216,175682,9,2/9/2021,3189949,1076552,1037170,39382,2113397,N,NULL,9,16/12/2020,NULL
254217,175682,10,2/10/2021,2139814,1076552,1050135,26417,1063262,N,NULL,9,16/12/2020,NULL
254218,175682,11,2/11/2021,1076552,1076552,1063262,13291,0,N,NULL,9,16/12/2020,NULL
254219,175683,1,2/1/2021,3037500,270775,233275,37500,2766725,N,NULL,9,16/12/2020,NULL
254220,175683,2,2/2/2021,2801309,270775,236191,34584,2530534,N,NULL,9,16/12/2020,NULL
254221,175683,3,2/3/2021,2562166,270775,239143,31632,2291391,N,NULL,9,16/12/2020,NULL
254222,175683,4,2/4/2021,2320033,270775,242133,28642,2049258,N,NULL,9,16/12/2020,NULL
254223,175683,5,2/5/2021,2074874,270775,245159,25616,1804099,N,NULL,9,16/12/2020,NULL
254224,175683,6,2/6/2021,1826650,270775,248224,22551,1555875,N,NULL,9,16/12/2020,NULL
254225,175683,7,2/7/2021,1575324,270775,251326,19448,1304549,N,NULL,9,16/12/2020,NULL
254226,175683,8,2/8/2021,1320856,270775,254468,16307,1050081,N,NULL,9,16/12/2020,NULL
254227,175683,9,2/9/2021,1063207,270775,257649,13126,792432,N,NULL,9,16/12/2020,NULL
254228,175683,10,2/10/2021,802337,270775,260870,9905,531562,N,NULL,9,16/12/2020,NULL
254229,175683,11,2/11/2021,538207,270775,264130,6645,267432,N,NULL,9,16/12/2020,NULL
254230,175683,12,2/12/2021,270775,270775,267432,3343,0,N,NULL,9,16/12/2020,NULL
254231,175684,1,16/01/2021,8100000,782947,682947,100000,7317053,N,NULL,9,17/12/2020,NULL
254232,175684,2,16/02/2021,7408516,782947,691484,91463,6625569,N,NULL,9,17/12/2020,NULL
254233,175684,3,16/03/2021,6708388,782947,700128,82820,5925441,N,NULL,9,17/12/2020,NULL
254234,175684,4,16/04/2021,5999509,782947,708879,74068,5216562,N,NULL,9,17/12/2020,NULL
254235,175684,5,16/05/2021,5281769,782947,717740,65207,4498822,N,NULL,9,17/12/2020,NULL
254236,175684,6,16/06/2021,4555057,782947,726712,56235,3772110,N,NULL,9,17/12/2020,NULL
254237,175684,7,16/07/2021,3819261,782947,735796,47151,3036314,N,NULL,9,17/12/2020,NULL
254238,175684,8,16/08/2021,3074268,782947,744993,37954,2291321,N,NULL,9,17/12/2020,NULL
254239,175684,9,16/09/2021,2319962,782947,754306,28642,1537015,N,NULL,9,17/12/2020,NULL
254240,175684,10,16/10/2021,1556228,782947,763734,19213,773281,N,NULL,9,17/12/2020,NULL
254241,175684,11,16/11/2021,782947,782947,773281,9666,0,N,NULL,9,17/12/2020,NULL
254242,175685,1,16/01/2021,20250000,969733,719733,250000,19280267,N,NULL,9,17/12/2020,NULL
254243,175685,2,16/02/2021,19521270,969733,728730,241003,18551537,N,NULL,9,17/12/2020,NULL
254244,175685,3,16/03/2021,18783431,969733,737839,231894,17813698,N,NULL,9,17/12/2020,NULL
254245,175685,4,16/04/2021,18036369,969733,747062,222671,17066636,N,NULL,9,17/12/2020,NULL
254246,175685,5,16/05/2021,17279969,969733,756400,213333,16310236,N,NULL,9,17/12/2020,NULL
254247,175685,6,16/06/2021,16514114,969733,765855,203878,15544381,N,NULL,9,17/12/2020,NULL
254248,175685,7,16/07/2021,15738686,969733,775428,194305,14768953,N,NULL,9,17/12/2020,NULL
254249,175685,8,16/08/2021,14953565,969733,785121,184612,13983832,N,NULL,9,17/12/2020,NULL
254250,175685,9,16/09/2021,14158630,969733,794935,174798,13188897,N,NULL,9,17/12/2020,NULL
254251,175685,10,16/10/2021,13353758,969733,804872,164861,12384025,N,NULL,9,17/12/2020,NULL
254252,175685,11,16/11/2021,12538825,969733,814933,154800,11569092,N,NULL,9,17/12/2020,NULL
254253,175685,12,16/12/2021,11713706,969733,825119,144614,10743973,N,NULL,9,17/12/2020,NULL
254254,175685,13,16/01/2022,10878273,969733,835433,134300,9908540,N,NULL,9,17/12/2020,NULL
254255,175685,14,16/02/2022,10032397,969733,845876,123857,9062664,N,NULL,9,17/12/2020,NULL
254256,175685,15,16/03/2022,9175947,969733,856450,113283,8206214,N,NULL,9,17/12/2020,NULL
254257,175685,16,16/04/2022,8308792,969733,867155,102578,7339059,N,NULL,9,17/12/2020,NULL
254258,175685,17,16/05/2022,7430797,969733,877995,91738,6461064,N,NULL,9,17/12/2020,NULL
254259,175685,18,16/06/2022,6541827,969733,888970,80763,5572094,N,NULL,9,17/12/2020,NULL
254260,175685,19,16/07/2022,5641745,969733,900082,69651,4672012,N,NULL,9,17/12/2020,NULL
254261,175685,20,16/08/2022,4730412,969733,911333,58400,3760679,N,NULL,9,17/12/2020,NULL
254262,175685,21,16/09/2022,3807688,969733,922724,47009,2837955,N,NULL,9,17/12/2020,NULL
254263,175685,22,16/10/2022,2873429,969733,934259,35474,1903696,N,NULL,9,17/12/2020,NULL
254264,175685,23,16/11/2022,1927492,969733,945937,23796,957759,N,NULL,9,17/12/2020,NULL
254265,175685,24,16/12/2022,969731,969733,957759,11972,0,N,NULL,9,17/12/2020,NULL
254266,175686,1,16/01/2021,1012500,257861,245361,12500,754639,N,NULL,9,17/12/2020,NULL
254267,175686,2,16/02/2021,764072,257861,248428,9433,506211,N,NULL,9,17/12/2020,NULL
254268,175686,3,16/03/2021,512539,257861,251533,6328,254678,N,NULL,9,17/12/2020,NULL
254269,175686,4,16/04/2021,257861,257861,254678,3183,0,N,NULL,9,17/12/2020,NULL
254270,175687,1,16/01/2021,3037500,187154,149654,37500,2850346,N,NULL,9,17/12/2020,NULL
254271,175687,2,16/02/2021,2885975,187154,151525,35629,2698821,N,NULL,9,17/12/2020,NULL
254272,175687,3,16/03/2021,2732556,187154,153419,33735,2545402,N,NULL,9,17/12/2020,NULL
254273,175687,4,16/04/2021,2577219,187154,155337,31818,2390065,N,NULL,9,17/12/2020,NULL
254274,175687,5,16/05/2021,2419940,187154,157279,29876,2232786,N,NULL,9,17/12/2020,NULL
254275,175687,6,16/06/2021,2260695,187154,159245,27910,2073541,N,NULL,9,17/12/2020,NULL
254276,175687,7,16/07/2021,2099460,187154,161235,25919,1912306,N,NULL,9,17/12/2020,NULL
254277,175687,8,16/08/2021,1936209,187154,163251,23904,1749055,N,NULL,9,17/12/2020,NULL
254278,175687,9,16/09/2021,1770918,187154,165291,21863,1583764,N,NULL,9,17/12/2020,NULL
254279,175687,10,16/10/2021,1603561,187154,167357,19797,1416407,N,NULL,9,17/12/2020,NULL
254280,175687,11,16/11/2021,1434112,187154,169449,17705,1246958,N,NULL,9,17/12/2020,NULL
254281,175687,12,16/12/2021,1262545,187154,171567,15587,1075391,N,NULL,9,17/12/2020,NULL
254282,175687,13,16/01/2022,1088833,187154,173712,13442,901679,N,NULL,9,17/12/2020,NULL
254283,175687,14,16/02/2022,912950,187154,175883,11271,725796,N,NULL,9,17/12/2020,NULL
254284,175687,15,16/03/2022,734868,187154,178082,9072,547714,N,NULL,9,17/12/2020,NULL
254285,175687,16,16/04/2022,554560,187154,180308,6846,367406,N,NULL,9,17/12/2020,NULL
254286,175687,17,16/05/2022,371998,187154,182562,4593,184844,N,NULL,9,17/12/2020,NULL
254287,175687,18,16/06/2022,187154,187154,184844,2311,0,N,NULL,9,17/12/2020,NULL
254288,175688,1,17/01/2021,119686078,4097736,2620130,1477606,115588342,N,NULL,9,18/12/2020,NULL
254289,175688,2,17/02/2021,117033197,4097736,2652881,1444854,112935461,N,NULL,9,18/12/2020,NULL
254290,175688,3,17/03/2021,114347155,4097736,2686042,1411693,110249419,N,NULL,9,18/12/2020,NULL
254291,175688,4,17/04/2021,111627537,4097736,2719618,1378118,107529801,N,NULL,9,18/12/2020,NULL
254292,175688,5,17/05/2021,108873924,4097736,2753613,1344123,104776188,N,NULL,9,18/12/2020,NULL
254293,175688,6,17/06/2021,106085891,4097736,2788033,1309702,101988155,N,NULL,9,18/12/2020,NULL
254294,175688,7,17/07/2021,103263007,4097736,2822884,1274852,99165271,N,NULL,9,18/12/2020,NULL
254295,175688,8,17/08/2021,100404837,4097736,2858170,1239566,96307101,N,NULL,9,18/12/2020,NULL
254296,175688,9,17/09/2021,97510940,4097736,2893897,1203839,93413204,N,NULL,9,18/12/2020,NULL
254297,175688,10,17/10/2021,94580870,4097736,2930070,1167665,90483134,N,NULL,9,18/12/2020,NULL
254298,175688,11,17/11/2021,91614174,4097736,2966696,1131039,87516438,N,NULL,9,18/12/2020,NULL
254299,175688,12,17/12/2021,88610394,4097736,3003780,1093955,84512658,N,NULL,9,18/12/2020,NULL
254300,175688,13,17/01/2022,85569067,4097736,3041327,1056408,81471331,N,NULL,9,18/12/2020,NULL
254301,175688,14,17/02/2022,82489723,4097736,3079344,1018392,78391987,N,NULL,9,18/12/2020,NULL
254302,175688,15,17/03/2022,79371887,4097736,3117836,979900,75274151,N,NULL,9,18/12/2020,NULL
254303,175688,16,17/04/2022,76215078,4097736,3156809,940927,72117342,N,NULL,9,18/12/2020,NULL
254304,175688,17,17/05/2022,73018809,4097736,3196269,901467,68921073,N,NULL,9,18/12/2020,NULL
254305,175688,18,17/06/2022,69782587,4097736,3236222,861513,65684851,N,NULL,9,18/12/2020,NULL
254306,175688,19,17/07/2022,66505912,4097736,3276675,821061,62408176,N,NULL,9,18/12/2020,NULL
254307,175688,20,17/08/2022,63188279,4097736,3317633,780102,59090543,N,NULL,9,18/12/2020,NULL
254308,175688,21,17/09/2022,59829175,4097736,3359104,738632,55731439,N,NULL,9,18/12/2020,NULL
254309,175688,22,17/10/2022,56428082,4097736,3401093,696643,52330346,N,NULL,9,18/12/2020,NULL
254310,175688,23,17/11/2022,52984476,4097736,3443606,654129,48886740,N,NULL,9,18/12/2020,NULL
254311,175688,24,17/12/2022,49497825,4097736,3486651,611084,45400089,N,NULL,9,18/12/2020,NULL
254312,175688,25,17/01/2023,45967591,4097736,3530234,567501,41869855,N,NULL,9,18/12/2020,NULL
254313,175688,26,17/02/2023,42393229,4097736,3574362,523373,38295493,N,NULL,9,18/12/2020,NULL
254314,175688,27,17/03/2023,38774187,4097736,3619042,478694,34676451,N,NULL,9,18/12/2020,NULL
254315,175688,28,17/04/2023,35109907,4097736,3664280,433456,31012171,N,NULL,9,18/12/2020,NULL
254316,175688,29,17/05/2023,31399824,4097736,3710083,387652,27302088,N,NULL,9,18/12/2020,NULL
254317,175688,30,17/06/2023,27643365,4097736,3756459,341276,23545629,N,NULL,9,18/12/2020,NULL
254318,175688,31,17/07/2023,23839950,4097736,3803415,294320,19742214,N,NULL,9,18/12/2020,NULL
254319,175688,32,17/08/2023,19988992,4097736,3850958,246778,15891256,N,NULL,9,18/12/2020,NULL
254320,175688,33,17/09/2023,16089897,4097736,3899095,198641,11992161,N,NULL,9,18/12/2020,NULL
254321,175688,34,17/10/2023,12142063,4097736,3947834,149902,8044327,N,NULL,9,18/12/2020,NULL
254322,175688,35,17/11/2023,8144882,4097736,3997181,100554,4047146,N,NULL,9,18/12/2020,NULL
254323,175688,36,17/12/2023,4097736,4097736,4047146,50589,0,N,NULL,9,18/12/2020,NULL
254324,175689,1,18/01/2021,2025000,348068,323068,25000,1676932,N,NULL,9,18/12/2020,NULL
254325,175689,2,18/02/2021,1697894,348068,327106,20962,1349826,N,NULL,9,18/12/2020,NULL
254326,175689,3,18/03/2021,1366699,348068,331195,16873,1018631,N,NULL,9,18/12/2020,NULL
254327,175689,4,18/04/2021,1031364,348068,335335,12733,683296,N,NULL,9,18/12/2020,NULL
254328,175689,5,18/05/2021,691838,348068,339526,8541,343770,N,NULL,9,18/12/2020,NULL
254329,175689,6,18/06/2021,348068,348068,343770,4297,0,N,NULL,9,18/12/2020,NULL
254330,175690,1,18/01/2021,3037500,270775,233275,37500,2766725,N,NULL,9,21/12/2020,NULL
254331,175690,2,18/02/2021,2801309,270775,236191,34584,2530534,N,NULL,9,21/12/2020,NULL
254332,175690,3,18/03/2021,2562166,270775,239143,31632,2291391,N,NULL,9,21/12/2020,NULL
254333,175690,4,18/04/2021,2320033,270775,242133,28642,2049258,N,NULL,9,21/12/2020,NULL
254334,175690,5,18/05/2021,2074874,270775,245159,25616,1804099,N,NULL,9,21/12/2020,NULL
254335,175690,6,18/06/2021,1826650,270775,248224,22551,1555875,N,NULL,9,21/12/2020,NULL
254336,175690,7,18/07/2021,1575324,270775,251326,19448,1304549,N,NULL,9,21/12/2020,NULL
254337,175690,8,18/08/2021,1320856,270775,254468,16307,1050081,N,NULL,9,21/12/2020,NULL
254338,175690,9,18/09/2021,1063207,270775,257649,13126,792432,N,NULL,9,21/12/2020,NULL
254339,175690,10,18/10/2021,802337,270775,260870,9905,531562,N,NULL,9,21/12/2020,NULL
254340,175690,11,18/11/2021,538207,270775,264130,6645,267432,N,NULL,9,21/12/2020,NULL
254341,175690,12,18/12/2021,270775,270775,267432,3343,0,N,NULL,9,21/12/2020,NULL
254342,175691,1,18/01/2021,3037500,396399,358899,37500,2641101,N,NULL,9,21/12/2020,NULL
254343,175691,2,18/02/2021,2674114,396399,363386,33014,2277715,N,NULL,9,21/12/2020,NULL
254344,175691,3,18/03/2021,2306186,396399,367928,28471,1909787,N,NULL,9,21/12/2020,NULL
254345,175691,4,18/04/2021,1933659,396399,372527,23872,1537260,N,NULL,9,21/12/2020,NULL
254346,175691,5,18/05/2021,1556475,396399,377184,19216,1160076,N,NULL,9,21/12/2020,NULL
254347,175691,6,18/06/2021,1174577,396399,381898,14501,778178,N,NULL,9,21/12/2020,NULL
254348,175691,7,18/07/2021,787905,396399,386672,9727,391506,N,NULL,9,21/12/2020,NULL
254349,175691,8,18/08/2021,396399,396399,391506,4894,0,N,NULL,9,21/12/2020,NULL
254350,175692,1,18/01/2021,67579506,2090502,1256187,834315,65489004,N,NULL,9,21/12/2020,NULL
254351,175692,2,18/02/2021,66307617,2090502,1271889,818613,64217115,N,NULL,9,21/12/2020,NULL
254352,175692,3,18/03/2021,65019829,2090502,1287788,802714,62929327,N,NULL,9,21/12/2020,NULL
254353,175692,4,18/04/2021,63715944,2090502,1303885,786617,61625442,N,NULL,9,21/12/2020,NULL
254354,175692,5,18/05/2021,62395760,2090502,1320184,770318,60305258,N,NULL,9,21/12/2020,NULL
254355,175692,6,18/06/2021,61059074,2090502,1336686,753816,58968572,N,NULL,9,21/12/2020,NULL
254356,175692,7,18/07/2021,59705680,2090502,1353394,737107,57615178,N,NULL,9,21/12/2020,NULL
254357,175692,8,18/08/2021,58335368,2090502,1370312,720190,56244866,N,NULL,9,21/12/2020,NULL
254358,175692,9,18/09/2021,56947927,2090502,1387441,703061,54857425,N,NULL,9,21/12/2020,NULL
254359,175692,10,18/10/2021,55543143,2090502,1404784,685718,53452641,N,NULL,9,21/12/2020,NULL
254360,175692,11,18/11/2021,54120799,2090502,1422344,668158,52030297,N,NULL,9,21/12/2020,NULL
254361,175692,12,18/12/2021,52680676,2090502,1440123,650379,50590174,N,NULL,9,21/12/2020,NULL
254362,175692,13,18/01/2022,51222552,2090502,1458124,632377,49132050,N,NULL,9,21/12/2020,NULL
254363,175692,14,18/02/2022,49746201,2090502,1476351,614151,47655699,N,NULL,9,21/12/2020,NULL
254364,175692,15,18/03/2022,48251396,2090502,1494805,595696,46160894,N,NULL,9,21/12/2020,NULL
254365,175692,16,18/04/2022,46737906,2090502,1513490,577011,44647404,N,NULL,9,21/12/2020,NULL
254366,175692,17,18/05/2022,45205497,2090502,1532409,558093,43114995,N,NULL,9,21/12/2020,NULL
254367,175692,18,18/06/2022,43653933,2090502,1551564,538937,41563431,N,NULL,9,21/12/2020,NULL
254368,175692,19,18/07/2022,42082974,2090502,1570959,519543,39992472,N,NULL,9,21/12/2020,NULL
254369,175692,20,18/08/2022,40492378,2090502,1590596,499906,38401876,N,NULL,9,21/12/2020,NULL
254370,175692,21,18/09/2022,38881900,2090502,1610478,480023,36791398,N,NULL,9,21/12/2020,NULL
254371,175692,22,18/10/2022,37251291,2090502,1630609,459892,35160789,N,NULL,9,21/12/2020,NULL
254372,175692,23,18/11/2022,35600299,2090502,1650992,439510,33509797,N,NULL,9,21/12/2020,NULL
254373,175692,24,18/12/2022,33928670,2090502,1671629,418872,31838168,N,NULL,9,21/12/2020,NULL
254374,175692,25,18/01/2023,32236145,2090502,1692525,397977,30145643,N,NULL,9,21/12/2020,NULL
254375,175692,26,18/02/2023,30522464,2090502,1713681,376821,28431962,N,NULL,9,21/12/2020,NULL
254376,175692,27,18/03/2023,28787362,2090502,1735102,355400,26696860,N,NULL,9,21/12/2020,NULL
254377,175692,28,18/04/2023,27030571,2090502,1756791,333711,24940069,N,NULL,9,21/12/2020,NULL
254378,175692,29,18/05/2023,25251820,2090502,1778751,311751,23161318,N,NULL,9,21/12/2020,NULL
254379,175692,30,18/06/2023,23450835,2090502,1800985,289516,21360333,N,NULL,9,21/12/2020,NULL
254380,175692,31,18/07/2023,21627338,2090502,1823497,267004,19536836,N,NULL,9,21/12/2020,NULL
254381,175692,32,18/08/2023,19781047,2090502,1846291,244210,17690545,N,NULL,9,21/12/2020,NULL
254382,175692,33,18/09/2023,17911677,2090502,1869370,221132,15821175,N,NULL,9,21/12/2020,NULL
254383,175692,34,18/10/2023,16018940,2090502,1892737,197765,13928438,N,NULL,9,21/12/2020,NULL
254384,175692,35,18/11/2023,14102544,2090502,1916396,174105,12012042,N,NULL,9,21/12/2020,NULL
254385,175692,36,18/12/2023,12162193,2090502,1940351,150151,10071691,N,NULL,9,21/12/2020,NULL
254386,175692,37,18/01/2024,10197588,2090502,1964605,125896,8107086,N,NULL,9,21/12/2020,NULL
254387,175692,38,18/02/2024,8208425,2090502,1989163,101339,6117923,N,NULL,9,21/12/2020,NULL
254388,175692,39,18/03/2024,6194397,2090502,2014028,76474,4103895,N,NULL,9,21/12/2020,NULL
254389,175692,40,18/04/2024,4155194,2090502,2039203,51299,2064692,N,NULL,9,21/12/2020,NULL
254390,175692,41,18/05/2024,2090501,2090502,2064692,25809,0,N,NULL,9,21/12/2020,NULL
254391,175693,1,18/01/2021,1745039,444422,422879,21544,1300617,N,NULL,9,21/12/2020,NULL
254392,175693,2,18/02/2021,1316874,444422,428165,16258,872452,N,NULL,9,21/12/2020,NULL
254393,175693,3,18/03/2021,883357,444422,433517,10906,438935,N,NULL,9,21/12/2020,NULL
254394,175693,4,18/04/2021,444421,444422,438935,5487,0,N,NULL,9,21/12/2020,NULL
254395,175694,1,18/01/2021,10125000,237899,112899,125000,9887101,N,NULL,9,21/12/2020,NULL
254396,175694,2,18/02/2021,10010689,237899,114311,123589,9772790,N,NULL,9,21/12/2020,NULL
254397,175694,3,18/03/2021,9894950,237899,115739,122160,9657051,N,NULL,9,21/12/2020,NULL
254398,175694,4,18/04/2021,9777764,237899,117186,120713,9539865,N,NULL,9,21/12/2020,NULL
254399,175694,5,18/05/2021,9659113,237899,118651,119248,9421214,N,NULL,9,21/12/2020,NULL
254400,175694,6,18/06/2021,9538979,237899,120134,117765,9301080,N,NULL,9,21/12/2020,NULL
254401,175694,7,18/07/2021,9417343,237899,121636,116263,9179444,N,NULL,9,21/12/2020,NULL
254402,175694,8,18/08/2021,9294187,237899,123156,114743,9056288,N,NULL,9,21/12/2020,NULL
254403,175694,9,18/09/2021,9169491,237899,124696,113204,8931592,N,NULL,9,21/12/2020,NULL
254404,175694,10,18/10/2021,9043237,237899,126254,111645,8805338,N,NULL,9,21/12/2020,NULL
254405,175694,11,18/11/2021,8915404,237899,127833,110067,8677505,N,NULL,9,21/12/2020,NULL
254406,175694,12,18/12/2021,8785974,237899,129430,108469,8548075,N,NULL,9,21/12/2020,NULL
254407,175694,13,18/01/2022,8654926,237899,131048,106851,8417027,N,NULL,9,21/12/2020,NULL
254408,175694,14,18/02/2022,8522240,237899,132686,105213,8284341,N,NULL,9,21/12/2020,NULL
254409,175694,15,18/03/2022,8387895,237899,134345,103554,8149996,N,NULL,9,21/12/2020,NULL
254410,175694,16,18/04/2022,8251871,237899,136024,101875,8013972,N,NULL,9,21/12/2020,NULL
254411,175694,17,18/05/2022,8114146,237899,137725,100175,7876247,N,NULL,9,21/12/2020,NULL
254412,175694,18,18/06/2022,7974700,237899,139446,98453,7736801,N,NULL,9,21/12/2020,NULL
254413,175694,19,18/07/2022,7833511,237899,141189,96710,7595612,N,NULL,9,21/12/2020,NULL
254414,175694,20,18/08/2022,7690557,237899,142954,94945,7452658,N,NULL,9,21/12/2020,NULL
254415,175694,21,18/09/2022,7545816,237899,144741,93158,7307917,N,NULL,9,21/12/2020,NULL
254416,175694,22,18/10/2022,7399266,237899,146550,91349,7161367,N,NULL,9,21/12/2020,NULL
254417,175694,23,18/11/2022,7250884,237899,148382,89517,7012985,N,NULL,9,21/12/2020,NULL
254418,175694,24,18/12/2022,7100647,237899,150237,87662,6862748,N,NULL,9,21/12/2020,NULL
254419,175694,25,18/01/2023,6948532,237899,152115,85784,6710633,N,NULL,9,21/12/2020,NULL
254420,175694,26,18/02/2023,6794516,237899,154016,83883,6556617,N,NULL,9,21/12/2020,NULL
254421,175694,27,18/03/2023,6638574,237899,155942,81958,6400675,N,NULL,9,21/12/2020,NULL
254422,175694,28,18/04/2023,6480683,237899,157891,80008,6242784,N,NULL,9,21/12/2020,NULL
254423,175694,29,18/05/2023,6320818,237899,159865,78035,6082919,N,NULL,9,21/12/2020,NULL
254424,175694,30,18/06/2023,6158955,237899,161863,76036,5921056,N,NULL,9,21/12/2020,NULL
254425,175694,31,18/07/2023,5995069,237899,163886,74013,5757170,N,NULL,9,21/12/2020,NULL
254426,175694,32,18/08/2023,5829134,237899,165935,71965,5591235,N,NULL,9,21/12/2020,NULL
254427,175694,33,18/09/2023,5661125,237899,168009,69890,5423226,N,NULL,9,21/12/2020,NULL
254428,175694,34,18/10/2023,5491016,237899,170109,67790,5253117,N,NULL,9,21/12/2020,NULL
254429,175694,35,18/11/2023,5318781,237899,172235,65664,5080882,N,NULL,9,21/12/2020,NULL
254430,175694,36,18/12/2023,5144393,237899,174388,63511,4906494,N,NULL,9,21/12/2020,NULL
254431,175694,37,18/01/2024,4967825,237899,176568,61331,4729926,N,NULL,9,21/12/2020,NULL
254432,175694,38,18/02/2024,4789050,237899,178775,59124,4551151,N,NULL,9,21/12/2020,NULL
254433,175694,39,18/03/2024,4608040,237899,181010,56889,4370141,N,NULL,9,21/12/2020,NULL
254434,175694,40,18/04/2024,4424767,237899,183273,54627,4186868,N,NULL,9,21/12/2020,NULL
254435,175694,41,18/05/2024,4239204,237899,185563,52336,4001305,N,NULL,9,21/12/2020,NULL
254436,175694,42,18/06/2024,4051321,237899,187883,50016,3813422,N,NULL,9,21/12/2020,NULL
254437,175694,43,18/07/2024,3861089,237899,190232,47668,3623190,N,NULL,9,21/12/2020,NULL
254438,175694,44,18/08/2024,3668480,237899,192609,45290,3430581,N,NULL,9,21/12/2020,NULL
254439,175694,45,18/09/2024,3473463,237899,195017,42882,3235564,N,NULL,9,21/12/2020,NULL
254440,175694,46,18/10/2024,3276008,237899,197455,40445,3038109,N,NULL,9,21/12/2020,NULL
254441,175694,47,18/11/2024,3076085,237899,199923,37976,2838186,N,NULL,9,21/12/2020,NULL
254442,175694,48,18/12/2024,2873663,237899,202422,35477,2635764,N,NULL,9,21/12/2020,NULL
254443,175694,49,18/01/2025,2668711,237899,204952,32947,2430812,N,NULL,9,21/12/2020,NULL
254444,175694,50,18/02/2025,2461197,237899,207514,30385,2223298,N,NULL,9,21/12/2020,NULL
254445,175694,51,18/03/2025,2251089,237899,210108,27791,2013190,N,NULL,9,21/12/2020,NULL
254446,175694,52,18/04/2025,2038355,237899,212734,25165,1800456,N,NULL,9,21/12/2020,NULL
254447,175694,53,18/05/2025,1822961,237899,215394,22506,1585062,N,NULL,9,21/12/2020,NULL
254448,175694,54,18/06/2025,1604875,237899,218086,19813,1366976,N,NULL,9,21/12/2020,NULL
254449,175694,55,18/07/2025,1384063,237899,220812,17087,1146164,N,NULL,9,21/12/2020,NULL
254450,175694,56,18/08/2025,1160491,237899,223572,14327,922592,N,NULL,9,21/12/2020,NULL
254451,175694,57,18/09/2025,934124,237899,226367,11532,696225,N,NULL,9,21/12/2020,NULL
254452,175694,58,18/10/2025,704927,237899,229197,8703,467028,N,NULL,9,21/12/2020,NULL
254453,175694,59,18/11/2025,472865,237899,232062,5838,234966,N,NULL,9,21/12/2020,NULL
254454,175694,60,18/12/2025,237903,237899,234966,2937,0,N,NULL,9,21/12/2020,NULL
254455,175695,1,21/01/2021,98145127,2306040,1094372,1211668,95839087,N,NULL,9,21/12/2020,NULL
254456,175695,2,21/02/2021,97037075,2306040,1108052,1197989,94731035,N,NULL,9,21/12/2020,NULL
254457,175695,3,21/03/2021,95915173,2306040,1121902,1184138,93609133,N,NULL,9,21/12/2020,NULL
254458,175695,4,21/04/2021,94779247,2306040,1135926,1170114,92473207,N,NULL,9,21/12/2020,NULL
254459,175695,5,21/05/2021,93629122,2306040,1150125,1155915,91323082,N,NULL,9,21/12/2020,NULL
254460,175695,6,21/06/2021,92464620,2306040,1164502,1141539,90158580,N,NULL,9,21/12/2020,NULL
254461,175695,7,21/07/2021,91285562,2306040,1179058,1126982,88979522,N,NULL,9,21/12/2020,NULL
254462,175695,8,21/08/2021,90091766,2306040,1193796,1112244,87785726,N,NULL,9,21/12/2020,NULL
254463,175695,9,21/09/2021,88883047,2306040,1208719,1097322,86577007,N,NULL,9,21/12/2020,NULL
254464,175695,10,21/10/2021,87659219,2306040,1223828,1082213,85353179,N,NULL,9,21/12/2020,NULL
254465,175695,11,21/11/2021,86420094,2306040,1239125,1066915,84114054,N,NULL,9,21/12/2020,NULL
254466,175695,12,21/12/2021,85165479,2306040,1254615,1051426,82859439,N,NULL,9,21/12/2020,NULL
254467,175695,13,21/01/2022,83895182,2306040,1270297,1035743,81589142,N,NULL,9,21/12/2020,NULL
254468,175695,14,21/02/2022,82609006,2306040,1286176,1019864,80302966,N,NULL,9,21/12/2020,NULL
254469,175695,15,21/03/2022,81306753,2306040,1302253,1003787,79000713,N,NULL,9,21/12/2020,NULL
254470,175695,16,21/04/2022,79988222,2306040,1318531,987509,77682182,N,NULL,9,21/12/2020,NULL
254471,175695,17,21/05/2022,78653209,2306040,1335013,971027,76347169,N,NULL,9,21/12/2020,NULL
254472,175695,18,21/06/2022,77301508,2306040,1351701,954340,74995468,N,NULL,9,21/12/2020,NULL
254473,175695,19,21/07/2022,75932911,2306040,1368597,937443,73626871,N,NULL,9,21/12/2020,NULL
254474,175695,20,21/08/2022,74547207,2306040,1385704,920336,72241167,N,NULL,9,21/12/2020,NULL
254475,175695,21,21/09/2022,73144181,2306040,1403026,903015,70838141,N,NULL,9,21/12/2020,NULL
254476,175695,22,21/10/2022,71723618,2306040,1420563,885477,69417578,N,NULL,9,21/12/2020,NULL
254477,175695,23,21/11/2022,70285298,2306040,1438320,867720,67979258,N,NULL,9,21/12/2020,NULL
254478,175695,24,21/12/2022,68828999,2306040,1456299,849741,66522959,N,NULL,9,21/12/2020,NULL
254479,175695,25,21/01/2023,67354496,2306040,1474503,831537,65048456,N,NULL,9,21/12/2020,NULL
254480,175695,26,21/02/2023,65861561,2306040,1492935,813106,63555521,N,NULL,9,21/12/2020,NULL
254481,175695,27,21/03/2023,64349965,2306040,1511596,794444,62043925,N,NULL,9,21/12/2020,NULL
254482,175695,28,21/04/2023,62819474,2306040,1530491,775549,60513434,N,NULL,9,21/12/2020,NULL
254483,175695,29,21/05/2023,61269852,2306040,1549622,756418,58963812,N,NULL,9,21/12/2020,NULL
254484,175695,30,21/06/2023,59700859,2306040,1568993,737048,57394819,N,NULL,9,21/12/2020,NULL
254485,175695,31,21/07/2023,58112254,2306040,1588605,717435,55806214,N,NULL,9,21/12/2020,NULL
254486,175695,32,21/08/2023,56503791,2306040,1608463,697578,54197751,N,NULL,9,21/12/2020,NULL
254487,175695,33,21/09/2023,54875223,2306040,1628568,677472,52569183,N,NULL,9,21/12/2020,NULL
254488,175695,34,21/10/2023,53226298,2306040,1648925,657115,50920258,N,NULL,9,21/12/2020,NULL
254489,175695,35,21/11/2023,51556761,2306040,1669537,636503,49250721,N,NULL,9,21/12/2020,NULL
254490,175695,36,21/12/2023,49866355,2306040,1690406,615634,47560315,N,NULL,9,21/12/2020,NULL
254491,175695,37,21/01/2024,48154819,2306040,1711536,594504,45848779,N,NULL,9,21/12/2020,NULL
254492,175695,38,21/02/2024,46421889,2306040,1732930,573110,44115849,N,NULL,9,21/12/2020,NULL
254493,175695,39,21/03/2024,44667297,2306040,1754592,551448,42361257,N,NULL,9,21/12/2020,NULL
254494,175695,40,21/04/2024,42890772,2306040,1776525,529516,40584732,N,NULL,9,21/12/2020,NULL
254495,175695,41,21/05/2024,41092041,2306040,1798731,507309,38786001,N,NULL,9,21/12/2020,NULL
254496,175695,42,21/06/2024,39270826,2306040,1821215,484825,36964786,N,NULL,9,21/12/2020,NULL
254497,175695,43,21/07/2024,37426846,2306040,1843980,462060,35120806,N,NULL,9,21/12/2020,NULL
254498,175695,44,21/08/2024,35559816,2306040,1867030,439010,33253776,N,NULL,9,21/12/2020,NULL
254499,175695,45,21/09/2024,33669448,2306040,1890368,415672,31363408,N,NULL,9,21/12/2020,NULL
254500,175695,46,21/10/2024,31755450,2306040,1913998,392043,29449410,N,NULL,9,21/12/2020,NULL
254501,175695,47,21/11/2024,29817527,2306040,1937923,368118,27511487,N,NULL,9,21/12/2020,NULL
254502,175695,48,21/12/2024,27855380,2306040,1962147,343894,25549340,N,NULL,9,21/12/2020,NULL
254503,175695,49,21/01/2025,25868707,2306040,1986673,319367,23562667,N,NULL,9,21/12/2020,NULL
254504,175695,50,21/02/2025,23857200,2306040,2011507,294533,21551160,N,NULL,9,21/12/2020,NULL
254505,175695,51,21/03/2025,21820549,2306040,2036651,269389,19514509,N,NULL,9,21/12/2020,NULL
254506,175695,52,21/04/2025,19758440,2306040,2062109,243931,17452400,N,NULL,9,21/12/2020,NULL
254507,175695,53,21/05/2025,17670555,2306040,2087885,218155,15364515,N,NULL,9,21/12/2020,NULL
254508,175695,54,21/06/2025,15556571,2306040,2113984,192056,13250531,N,NULL,9,21/12/2020,NULL
254509,175695,55,21/07/2025,13416162,2306040,2140409,165632,11110122,N,NULL,9,21/12/2020,NULL
254510,175695,56,21/08/2025,11248998,2306040,2167164,138877,8942958,N,NULL,9,21/12/2020,NULL
254511,175695,57,21/09/2025,9054745,2306040,2194253,111787,6748705,N,NULL,9,21/12/2020,NULL
254512,175695,58,21/10/2025,6833064,2306040,2221681,84359,4527024,N,NULL,9,21/12/2020,NULL
254513,175695,59,21/11/2025,4583612,2306040,2249452,56588,2277572,N,NULL,9,21/12/2020,NULL
254514,175695,60,21/12/2025,2306041,2306040,2277572,28470,0,N,NULL,9,21/12/2020,NULL
254515,175696,1,21/01/2021,9999244,342348,218900,123447,9656896,N,NULL,9,21/12/2020,NULL
254516,175696,2,21/02/2021,9777607,342348,221637,120711,9435259,N,NULL,9,21/12/2020,NULL
254517,175696,3,21/03/2021,9553200,342348,224407,117941,9210852,N,NULL,9,21/12/2020,NULL
254518,175696,4,21/04/2021,9325988,342348,227212,115136,8983640,N,NULL,9,21/12/2020,NULL
254519,175696,5,21/05/2021,9095936,342348,230052,112296,8753588,N,NULL,9,21/12/2020,NULL
254520,175696,6,21/06/2021,8863008,342348,232928,109420,8520660,N,NULL,9,21/12/2020,NULL
254521,175696,7,21/07/2021,8627169,342348,235839,106508,8284821,N,NULL,9,21/12/2020,NULL
254522,175696,8,21/08/2021,8388382,342348,238787,103560,8046034,N,NULL,9,21/12/2020,NULL
254523,175696,9,21/09/2021,8146610,342348,241772,100575,7804262,N,NULL,9,21/12/2020,NULL
254524,175696,10,21/10/2021,7901816,342348,244794,97553,7559468,N,NULL,9,21/12/2020,NULL
254525,175696,11,21/11/2021,7653962,342348,247854,94493,7311614,N,NULL,9,21/12/2020,NULL
254526,175696,12,21/12/2021,7403009,342348,250953,91395,7060661,N,NULL,9,21/12/2020,NULL
254527,175696,13,21/01/2022,7148920,342348,254089,88258,6806572,N,NULL,9,21/12/2020,NULL
254528,175696,14,21/02/2022,6891654,342348,257266,85082,6549306,N,NULL,9,21/12/2020,NULL
254529,175696,15,21/03/2022,6631173,342348,260481,81866,6288825,N,NULL,9,21/12/2020,NULL
254530,175696,16,21/04/2022,6367436,342348,263737,78610,6025088,N,NULL,9,21/12/2020,NULL
254531,175696,17,21/05/2022,6100402,342348,267034,75314,5758054,N,NULL,9,21/12/2020,NULL
254532,175696,18,21/06/2022,5830030,342348,270372,71976,5487682,N,NULL,9,21/12/2020,NULL
254533,175696,19,21/07/2022,5556278,342348,273752,68596,5213930,N,NULL,9,21/12/2020,NULL
254534,175696,20,21/08/2022,5279104,342348,277174,65174,4936756,N,NULL,9,21/12/2020,NULL
254535,175696,21,21/09/2022,4998466,342348,280638,61709,4656118,N,NULL,9,21/12/2020,NULL
254536,175696,22,21/10/2022,4714320,342348,284146,58201,4371972,N,NULL,9,21/12/2020,NULL
254537,175696,23,21/11/2022,4426622,342348,287698,54650,4084274,N,NULL,9,21/12/2020,NULL
254538,175696,24,21/12/2022,4135328,342348,291294,51053,3792980,N,NULL,9,21/12/2020,NULL
254539,175696,25,21/01/2023,3840393,342348,294935,47412,3498045,N,NULL,9,21/12/2020,NULL
254540,175696,26,21/02/2023,3541771,342348,298622,43726,3199423,N,NULL,9,21/12/2020,NULL
254541,175696,27,21/03/2023,3239416,342348,302355,39993,2897068,N,NULL,9,21/12/2020,NULL
254542,175696,28,21/04/2023,2933282,342348,306134,36213,2590934,N,NULL,9,21/12/2020,NULL
254543,175696,29,21/05/2023,2623321,342348,309961,32387,2280973,N,NULL,9,21/12/2020,NULL
254544,175696,30,21/06/2023,2309485,342348,313836,28512,1967137,N,NULL,9,21/12/2020,NULL
254545,175696,31,21/07/2023,1991726,342348,317759,24589,1649378,N,NULL,9,21/12/2020,NULL
254546,175696,32,21/08/2023,1669995,342348,321731,20617,1327647,N,NULL,9,21/12/2020,NULL
254547,175696,33,21/09/2023,1344243,342348,325752,16596,1001895,N,NULL,9,21/12/2020,NULL
254548,175696,34,21/10/2023,1014419,342348,329824,12524,672071,N,NULL,9,21/12/2020,NULL
254549,175696,35,21/11/2023,680472,342348,333947,8401,338124,N,NULL,9,21/12/2020,NULL
254550,175696,36,21/12/2023,342351,342348,338124,4227,0,N,NULL,9,21/12/2020,NULL
